individual,id,Ntot,N1,ND,N0,raw,score,propscore,theta,se.theta,outfit,infit
137,137,15,15,0,0,15,14.700000000000001,0.9800000000000001,4.444070778830723,1.8683846802267072,0.021004553652086463,0.048178582929301876
106,106,14,13,0,1,13,12.742857142857146,0.9102040816326532,2.259033257091348,0.965233982233862,0.5333742130364314,0.8432255611679328
132,132,13,12,0,1,12,11.746153846153847,0.9035502958579882,3.2573531711267365,0.9717527869754946,0.33438266898894603,0.6758226961867116
139,139,13,12,0,1,12,11.746153846153847,0.9035502958579882,2.4627889876846685,1.022743512861136,0.15380667211040427,0.3748291693995188
12,12,15,13,0,2,13,12.780000000000001,0.8520000000000001,2.3435009759231913,0.798230263434777,1.7394907449883814,1.117178537367965
44,44,15,13,0,2,13,12.780000000000001,0.8520000000000001,2.0640796163080353,0.7686668145554088,0.46935762398289554,0.6775876783587271
85,85,15,13,0,2,13,12.780000000000001,0.8520000000000001,2.884269534199123,0.7876335866519167,0.3921956186701633,0.7596042730607446
150,150,14,12,0,2,12,11.785714285714286,0.8418367346938777,2.5732125459193878,0.81355612791249865,0.7018515916682612,0.8622359238034709
122,122,13,11,0,2,11,10.792307692307693,0.8301775147928995,2.3100457997684782,0.8364080804487891,1.0577163979997322,1.2232775281218182
135,135,13,11,0,2,11,10.792307692307693,0.8301775147928995,2.0609770660491016,0.7816562792231608,0.6802627447611006,0.9856309846840308
39,39,12,10,0,2,10,9.8,0.8166666666666668,1.86331490666832,0.7926339104751425,1.0613899089883332,1.1917133306002154
65,65,12,10,0,2,10,9.8,0.8166666666666668,1.9625364580939977,0.8179343219815872,0.7543583327379473,1.1519260360715418
66,66,14,11,0,3,11,10.82857142857143,0.7734693877551021,2.1867182643259793,0.7121239932918375,0.8913072115511491,1.1885957737010355
93,93,14,11,0,3,11,10.82857142857143,0.7734693877551021,1.4193906975648198,0.676020490916889,0.541980997717794,0.7563411664532984
103,103,14,11,0,3,11,10.82857142857143,0.7734693877551021,2.1052812458613204,0.8350639891970271,4.524841466440672,1.6372511266223404
108,108,14,11,0,3,11,10.82857142857143,0.7734693877551021,2.213456463004876,0.7187226356587929,0.6121039979166571,0.8426851775974921
113,113,14,11,0,3,11,10.82857142857143,0.7734693877551021,1.9808636298200637,0.7323333913347573,0.8619159760152885,1.1156959423565767
13,13,9,7,0,2,7,6.833333333333334,0.7592592592592593,1.1892333637545984,0.8527798133073478,0.46195795420260155,0.6882552235213855
78,78,13,10,0,3,10,9.838461538461539,0.7568047337278107,1.0410061445467722,0.7121201859124078,0.5409782710619344,0.7971321234774923
88,88,13,10,0,3,10,9.838461538461539,0.7568047337278107,1.0421884552993008,0.7312242144628327,0.5175294678131126,0.7421074888293622
117,117,43,32,0,11,32,31.85348837209302,0.7407787993510005,2.0212603909933096,0.35992816542586253,0.9031522858465058,0.9831611122699389
20,20,12,9,0,3,9,8.850000000000001,0.7375000000000002,1.9441478400155607,0.7548739118395211,0.416419287445732,0.6221331312725692
8,8,15,11,0,4,11,10.860000000000001,0.7240000000000001,1.029988288114755,0.6459527340228244,1.038786266592796,1.0990998553721236
79,79,15,11,0,4,11,10.860000000000001,0.7240000000000001,1.3236420653650185,0.6338076217933141,0.673804955768212,0.8570764852096387
34,34,11,8,0,3,8,7.863636363636363,0.7148760330578512,1.9577940796999025,0.7374295698296395,0.4212555461074663,0.5582200468194707
40,40,11,8,0,3,8,7.863636363636363,0.7148760330578512,0.8302589065963532,0.7667607155819025,0.5700666617624752,0.7063983699118777
101,101,11,8,0,3,8,7.863636363636363,0.7148760330578512,0.9606148858497913,0.7849433465821808,0.7908712235729479,0.9224721578563257
89,89,14,10,0,4,10,9.871428571428572,0.7051020408163265,1.610739509685168,0.7582715913694461,3.272709378753916,0.9507555577606338
131,131,14,10,0,4,10,9.871428571428572,0.7051020408163265,1.6759921869860737,0.6892150184460257,0.5133659169562028,0.7295377314784101
59,59,13,9,0,4,9,8.884615384615387,0.683431952662722,0.3352900927318907,0.6758380300895129,0.831155610456529,0.9864223939367052
96,96,13,9,0,4,9,8.884615384615387,0.683431952662722,0.1658909563040027,0.6387837176545628,0.6954460708799052,0.8552195715675165
140,140,13,9,0,4,9,8.884615384615387,0.683431952662722,1.1495622942045414,0.7070665663452597,0.5747701865109175,0.825315288805577
35,35,45,30,0,15,30,29.900000000000002,0.6644444444444445,1.170196170097713,0.3250115954424219,0.9166478852623835,0.972794712443602
10,10,15,10,0,5,10,9.9,0.66,1.2906939147121252,0.632030903057348,0.542897047213318,0.7481515998103774
51,51,15,10,0,5,10,9.9,0.66,0.9989663506395425,0.6088213193957662,0.5940519686754963,0.7635797057254023
102,102,15,10,0,5,10,9.9,0.66,0.3967199767079932,0.6204608010048187,0.7747225459709468,0.9423250356150282
16,16,12,8,0,4,8,7.9,0.6583333333333333,0.644265619106188,0.6570780113530701,0.9132920560285788,1.0447839401763495
17,17,12,8,0,4,8,7.9,0.6583333333333333,0.29512470357351556,0.7201641677387987,0.450062165437817,0.6208262961630373
55,55,12,8,0,4,8,7.9,0.6583333333333333,0.5109486201369432,0.6666073635053864,0.6949892510991073,0.8621834902316383
124,124,12,8,0,4,8,7.9,0.6583333333333333,0.28932241747771587,0.7053591820563093,0.6276969216157958,0.8359365852685586
45,45,14,9,0,5,9,8.914285714285716,0.6367346938775512,0.07917006748388918,0.6083055481706683,0.8747640443347431,0.9452268595357612
77,77,14,9,0,5,9,8.914285714285716,0.6367346938775512,0.9700024102714302,0.6122985407690866,1.4299278389620846,1.5016660672699416
81,81,14,9,0,5,9,8.914285714285716,0.6367346938775512,0.9490047401775906,0.6004744481852702,0.5541971133079073,0.6128003558785907
87,87,14,9,0,5,9,8.914285714285716,0.6367346938775512,0.44300643932049877,0.6861044826463766,1.947260424188397,1.6322419760325018
149,149,14,9,0,5,9,8.914285714285716,0.6367346938775512,0.8892872805508292,0.594163593342407,0.8970047686184114,1.0095795530573413
11,11,11,7,0,4,7,6.918181818181818,0.6289256198347107,1.418195831074903,0.6947402647437219,2.083783470712049,1.3801137807219817
121,121,16,10,0,6,10,9.925,0.6203125,0.679968157039726,0.5685029173996956,0.6554883048162949,0.7867064290858813
7,7,13,8,0,5,8,7.930769230769231,0.6100591715976331,0.8430363020491106,0.6517608382232581,0.8860538432176306,0.9257090695850815
36,36,13,8,0,5,8,7.930769230769231,0.6100591715976331,0.3846861613482637,0.664876508878412,0.8476152842280483,0.9785448819888674
53,53,13,8,0,5,8,7.930769230769231,0.6100591715976331,1.0893547366122283,0.6343097766254501,1.02450194521614,0.9834270898763855
97,97,13,8,0,5,8,7.930769230769231,0.6100591715976331,-0.09544455905345758,0.6222804077157655,1.1792952707734388,1.1027300061240133
24,24,45,27,0,18,27,26.94,0.5986666666666667,0.5717704948032071,0.32217249911849855,0.8813344641552979,0.9381138826817239
3,3,15,9,0,6,9,8.94,0.596,0.15862554104311605,0.5964959322680596,0.5686213847830989,0.6990413348542898
60,60,15,9,0,6,9,8.94,0.596,0.09922137918384971,0.5990565871027612,0.6320569833568961,0.7897153007735194
128,128,15,9,0,6,9,8.94,0.596,0.9371457202671464,0.5771916525953282,1.0287589350033284,1.041657660378665
49,49,10,6,0,4,6,5.94,0.5940000000000001,0.5286958621944666,0.7545439907368249,0.4908497050153594,0.6304831133586921
120,120,12,7,0,5,7,6.949999999999999,0.5791666666666666,0.08980883673642759,0.6815875975208865,0.8142466338434259,0.9721535287163887
126,126,12,7,0,5,7,6.949999999999999,0.5791666666666666,0.6268503361638322,0.6857649478015062,0.9419878193834558,1.06031090888305
58,58,14,8,0,6,8,7.957142857142857,0.5683673469387756,0.1387537813497808,0.6024487042938028,0.6843152058060251,0.7905881738408554
84,84,14,8,0,6,8,7.957142857142857,0.5683673469387756,0.411472188777615,0.6297170190243271,0.9283433805763169,1.0008559975542417
114,114,14,8,0,6,8,7.957142857142857,0.5683673469387756,0.7456802478424496,0.6086153134101356,1.3503709228296208,1.429068403747397
133,133,14,8,0,6,8,7.957142857142857,0.5683673469387756,0.27623268750054963,0.5786236346162797,0.9372000291822433,0.9662601358770015
30,30,16,9,0,7,9,8.9625,0.56015625,0.42248578834477346,0.5482619414700868,1.262118032556161,1.3109595022991147
69,69,16,9,0,7,9,8.9625,0.56015625,0.0140257260441882,0.5525337728213301,1.4130267077353091,1.3101726475548063
2,2,13,7,0,6,7,6.976923076923076,0.5366863905325443,0.08936046916529872,0.591266143236223,0.6957736591473432,0.7317158219362863
23,23,13,7,0,6,7,6.976923076923076,0.5366863905325443,-0.04638596497365316,0.630165990534516,0.9101110704478281,1.0019700546925019
46,46,13,7,0,6,7,6.976923076923076,0.5366863905325443,-0.5185827937075944,0.6486376803771571,0.884104940607206,1.008842229382327
47,47,13,7,0,6,7,6.976923076923076,0.5366863905325443,0.6190146264773356,0.6837037597861296,0.6652290670022823,0.8130802316830891
127,127,13,7,0,6,7,6.976923076923076,0.5366863905325443,1.230196186846029,0.67003490742795,0.6550922911381684,0.7415753138368735
145,145,13,7,0,6,7,6.976923076923076,0.5366863905325443,0.28334907609835264,0.7150608965252259,0.8645241557036338,1.0538179149146325
82,82,15,8,0,7,8,7.98,0.532,-0.37797803258448437,0.5903246086942311,0.8254465588144557,1.0207570943537372
91,91,15,8,0,7,8,7.98,0.532,0.4195431702108235,0.5601644947584382,1.3386154881820367,1.1800615012524496
146,146,15,8,0,7,8,7.98,0.532,0.9187354158807916,0.5739619925877012,0.6925981309130319,0.7556026877746247
148,148,12,6,0,6,6,6,0.5,-0.8865753693363873,0.6987411396256187,1.0445256563738246,1.006957825117872
28,28,15,7,0,8,7,7.02,0.46799999999999997,0.12905380990238843,0.5917770759412897,0.954557150794661,1.1393960267709904
74,74,15,7,0,8,7,7.02,0.46799999999999997,-0.233696587117584,0.5674940282930864,0.9682116405280297,1.0305397768680344
116,116,15,7,0,8,7,7.02,0.46799999999999997,-0.32654523516843986,0.5945116347360415,1.4821924145958363,1.4288028434277902
136,136,15,7,0,8,7,7.02,0.46799999999999997,-0.027255520007749515,0.6320845719846477,0.7789426541706448,0.9630677439789334
27,27,45,21,0,24,21,21.02,0.4671111111111111,0.5638683812450607,0.32678205282234757,0.8461977564602252,0.9300077485062654
6,6,13,6,0,7,6,6.023076923076923,0.4633136094674556,0.6178126128500419,0.69351829462499,1.4484560128743726,1.4429560985776249
41,41,13,6,0,7,6,6.023076923076923,0.4633136094674556,-0.6506217951150192,0.6368911605267802,1.4293830219774353,1.3758128143955337
48,48,13,6,0,7,6,6.023076923076923,0.4633136094674556,0.8226390564383472,0.646698208804787,1.1679514029647433,1.2755269777155804
52,52,13,6,0,7,6,6.023076923076923,0.4633136094674556,-0.024846915809864888,0.6755649653558561,0.8752911549263783,0.9909138258709083
54,54,13,6,0,7,6,6.023076923076923,0.4633136094674556,-0.523861404581987,0.6398744566392988,0.6801637978768833,0.8562097675060255
86,86,13,6,0,7,6,6.023076923076923,0.4633136094674556,0.24043580791137192,0.6619069657744711,1.0329616558824501,1.1555172633799562
99,99,13,6,0,7,6,6.023076923076923,0.4633136094674556,0.0803202323096356,0.6697658551413842,1.5584883648382473,1.398767169124374
109,109,13,6,0,7,6,6.023076923076923,0.4633136094674556,-0.11012830433035564,0.6334294616832264,0.7516200693743555,0.8830735564260259
111,111,11,5,0,6,5,5.027272727272727,0.4570247933884298,-0.4146792187999336,0.6675972840740094,0.8901699542255763,1.0217488627237516
37,37,16,7,0,9,7,7.0375,0.43984375,-0.43250351542370236,0.5891434792414391,0.8429412879844033,0.8776554193184093
15,15,14,6,0,8,6,6.042857142857143,0.4316326530612245,0.09920117721462796,0.6356067992066443,0.9670260436226703,1.1556053999407192
33,33,14,6,0,8,6,6.042857142857143,0.4316326530612245,0.5122023035899043,0.6322624686387622,0.48520787224742784,0.6007334941386103
61,61,14,6,0,8,6,6.042857142857143,0.4316326530612245,-0.43000172168518513,0.6324618918038978,0.7391263481863131,0.8771301079958497
76,76,14,6,0,8,6,6.042857142857143,0.4316326530612245,0.46439679888123203,0.5984645998617982,0.5806918346682233,0.6547535174251646
98,98,14,6,0,8,6,6.042857142857143,0.4316326530612245,-0.14546582843411732,0.614278026079049,0.8609319200656366,0.9991816444505337
147,147,14,6,0,8,6,6.042857142857143,0.4316326530612245,-0.508545046862375,0.6333696106156654,0.7453719067202267,0.9327740144255637
1,1,12,5,0,7,5,5.05,0.42083333333333334,0.34484724734187594,0.7037212260660409,0.5782566887415663,0.7713441311432697
22,22,12,5,0,7,5,5.05,0.42083333333333334,-0.606710923770739,0.664722813376637,0.6409783678191247,0.758331700675671
94,94,12,5,0,7,5,5.05,0.42083333333333334,0.5049669551704695,0.6764579927084433,0.5407426840516033,0.6694646764179623
138,138,12,5,0,7,5,5.05,0.42083333333333334,-0.7473011260237387,0.7159040741903607,0.4240927914275216,0.5640437914635796
144,144,42,17,0,25,17,17.057142857142857,0.4061224489795918,-0.053009532277412626,0.3351650268692081,0.9651265829158782,1.0219891914823402
19,19,10,4,0,6,4,4.0600000000000005,0.406,0.08494701770800958,0.7974547032755682,0.5329830252389809,0.6923126763961198
18,18,15,6,0,9,6,6.0600000000000005,0.404,-0.7474366255109564,0.583793789112207,2.3555684650111406,1.294441780058528
92,92,15,6,0,9,6,6.0600000000000005,0.404,-1.067110494501874,0.6220932018416401,0.9591908347018342,1.0254904387196366
119,119,15,6,0,9,6,6.0600000000000005,0.404,-0.6870594536232257,0.5685334460433233,0.980591412936194,1.0397522053806663
9,9,13,5,0,8,5,5.069230769230769,0.3899408284023668,-0.7801310658152925,0.6727422217618294,0.6471322266767638,0.8516284010141532
56,56,13,5,0,8,5,5.069230769230769,0.3899408284023668,-0.5471640283691585,0.7000803648158982,0.5837193914487325,0.7069602861262171
75,75,13,5,0,8,5,5.069230769230769,0.3899408284023668,-0.5617609135961054,0.6988637845219227,0.8331882703182301,0.9385006920898454
112,112,13,5,0,8,5,5.069230769230769,0.3899408284023668,-0.012681779678045192,0.6703722909257591,1.0533408380634628,1.0643895642102363
142,142,13,5,0,8,5,5.069230769230769,0.3899408284023668,-0.324846466753801,0.619359587184107,0.8642622852016082,0.9792259845821323
143,143,13,5,0,8,5,5.069230769230769,0.3899408284023668,-1.0427368267612414,0.6360415092476964,0.9619825529029347,1.094015816358084
129,129,11,4,0,7,4,4.081818181818182,0.37107438016528926,-0.7856336513996842,0.6830075363124618,0.8527599965152816,0.9926732272326262
130,130,11,4,0,7,4,4.081818181818182,0.37107438016528926,-1.5434530380563236,0.7653191668120297,1.0817613632494976,1.0926702971067033
43,43,14,5,0,9,5,5.085714285714285,0.36326530612244895,0.2432378672868132,0.6820781932483738,0.824845712199992,0.9453387015347287
83,83,14,5,0,9,5,5.085714285714285,0.36326530612244895,-1.249529888249967,0.641745509285298,0.764138222110122,0.8879007887112828
32,32,12,4,0,8,4,4.1000000000000005,0.34166666666666673,-1.6579372990194101,0.7073084379754615,0.3954348758451099,0.504904974251929
68,68,12,4,0,8,4,4.1000000000000005,0.34166666666666673,-1.5845121369933601,0.7438429678059194,0.5486713121521762,0.7719923095798403
70,70,15,5,0,10,5,5.1,0.33999999999999997,-0.7880344494428736,0.645756582116988,0.986000953173688,1.2446332047524433
100,100,15,5,0,10,5,5.1,0.33999999999999997,-0.45711266945835344,0.6453061389953213,0.5141259197490674,0.6863517730671179
141,141,45,15,0,30,15,15.100000000000001,0.3355555555555556,1.0001358142737964,0.3429520080784351,0.9374917610829729,0.9792847521858337
72,72,13,4,0,9,4,4.115384615384616,0.31656804733727817,-1.0479857095494947,0.6976476781801513,0.6202990002925003,0.8395756965655695
26,26,14,4,0,10,4,4.128571428571429,0.2948979591836735,-1.7688553785823904,0.7112830712089854,0.7989804128607831,0.9864885639164872
73,73,14,4,0,10,4,4.128571428571429,0.2948979591836735,-1.2908425207878271,0.682528371855536,0.5244408261723187,0.7552246579350804
80,80,11,3,0,8,3,3.1363636363636362,0.28512396694214875,-0.6087426347540155,0.8948569425732235,0.3177133775225938,0.5240831429258865
107,107,15,4,0,11,4,4.140000000000001,0.276,-1.4723612428296355,0.6907277683942271,0.4764623740949415,0.7174721716603996
110,110,15,4,0,11,4,4.140000000000001,0.276,-1.9569522286144736,0.6905088546455541,1.5098651374902632,1.5373477923093306
118,118,15,4,0,11,4,4.140000000000001,0.276,-0.4382943233026487,0.6379087284688086,0.4260589570196745,0.557451891339738
50,50,12,3,0,9,3,3.15,0.2625,-1.5229106179614114,0.7944020581952497,0.5100211398089599,0.8023138297285871
14,14,13,3,0,10,3,3.1615384615384614,0.24319526627218935,-0.7957492534650166,0.7017016514619718,0.619103739021229,0.769225426582752
25,25,13,3,0,10,3,3.1615384615384614,0.24319526627218935,-0.9264002005889332,0.7208726324408203,0.406972105597967,0.5929213083532443
29,29,13,3,0,10,3,3.1615384615384614,0.24319526627218935,-1.0047420578067228,0.7831053844312132,0.4365045879906493,0.6425193642671426
134,134,13,3,0,10,3,3.1615384615384614,0.24319526627218935,-1.9146129214729732,0.9490523795406757,0.2801148169672322,0.5842748651957209
57,57,9,2,0,7,2,2.1666666666666665,0.24074074074074073,-1.2041506013076535,1.028388794763271,0.5789254749232673,0.9795561296124256
5,5,14,3,0,11,3,3.1714285714285713,0.22653061224489796,-1.1143528671483438,0.7161337640074887,1.4422556783716474,1.1538459212357313
38,38,14,3,0,11,3,3.1714285714285713,0.22653061224489796,-1.423893919124373,0.8061539688230916,0.24245578538027707,0.44032019363968633
64,64,10,2,0,8,2,2.18,0.21800000000000003,-2.0734365843152274,0.9846579893559172,1.3916566308316256,1.0688754804126237
63,63,16,3,0,13,3,3.1875,0.19921875,-1.5063863360684036,0.6726695784249352,0.40064380990379944,0.598032184394502
125,125,16,3,0,13,3,3.1875,0.19921875,-2.8040164353237205,0.8640332946840423,0.24251650590867208,0.5044183538629737
95,95,12,2,0,10,2,2.2,0.18333333333333335,-1.1904990876620516,0.7734705699253897,0.7533717329588807,0.8948832725347505
123,123,12,2,0,10,2,2.2,0.18333333333333335,-1.9911032432327622,0.8875075621810394,0.4091648638400131,0.6352517068416668
105,105,14,2,0,12,2,2.2142857142857144,0.15816326530612246,-1.8203675199689509,0.7791379814262369,0.5623901696603956,0.8111708902366406
104,104,15,2,0,13,2,2.22,0.14800000000000002,-1.2927464754136002,0.794655163140346,0.7461865234908417,1.169558059374335
67,67,13,1,0,12,1,1.2538461538461538,0.09644970414201183,-1.9158329691589644,0.9575366324139197,4.398641015539497,1.0332639884409252
42,42,14,1,0,13,1,1.2571428571428571,0.08979591836734693,-3.5795993840917104,1.3579523267580391,0.049787954970133365,0.1303772980706064
90,90,14,1,0,13,1,1.2571428571428571,0.08979591836734693,-2.1347233556000185,0.9854114883885765,3.1326141726989376,1.1459928251757958
62,62,9,0,0,9,0,0.3,0.03333333333333333,-3.0746120567871404,1.925527376899797,0.03721181576175773,0.11134399261696444
31,31,12,0,0,12,0,0.3,0.024999999999999998,-4.87429822506281,1.8839082574028108,0.02662597682570109,0.06379999558443152
115,115,13,0,0,13,0,0.3,0.023076923076923075,-4.973587995341974,1.881037202533039,0.02448657293006442,0.06052977363224175
21,21,15,0,0,15,0,0.3,0.02,-5.108238692966673,1.9391154998210847,0.02270062632428104,0.12714929116778578
71,71,15,0,0,15,0,0.3,0.02,-3.7937317272082427,1.8644078452451214,0.02082818296265401,0.04181240836299382
4,4,16,0,0,16,0,0.3,0.01875,-4.6781786260294105,1.860396527515524,0.019437041293441544,0.037255522339710155
