individual,id,Ntot,N1,ND,N0,raw,score,propscore,theta,se.theta,outfit,infit
63,43,15,14,0,1,14,13.74,0.916,4.342762386423438,0.9829969866585482,0.25988654136938266,0.6642894330589446
153,111,19,16,0,3,16,15.794736842105262,0.8313019390581717,3.0838953172521495,0.6438822340382182,0.8468214014801411,0.9797138252384533
167,118,12,10,0,2,10,9.8,0.8166666666666668,2.0447669131560295,0.7918454590846917,0.8977702375285542,1.1384541819045289
228,166,17,14,0,3,14,13.805882352941175,0.8121107266435985,3.005495340642524,0.7008307923138283,0.9191752962689562,0.9510240886108116
40,27,16,13,0,3,13,12.812500000000002,0.8007812500000001,2.7013113539646394,0.6918255888177892,0.6576275349174147,0.8797194960368161
126,90,16,13,0,3,13,12.812500000000002,0.8007812500000001,3.3455805204785953,0.76111637065457,0.6658742515969753,1.1231905592275668
146,105,15,12,0,3,12,11.820000000000002,0.7880000000000001,2.6358531409271677,0.6875590962373883,0.9067298267164859,1.1979732861949741
72,49,10,8,0,2,8,7.82,0.782,1.4954930616449986,0.8433104308957916,0.5454605304761205,0.731566835071817
215,154,19,15,0,4,15,14.826315789473686,0.7803324099722992,1.9493549083710093,0.6076350552074736,1.2595779841988104,1.0146930618883057
31,18,18,14,0,4,14,13.833333333333332,0.7685185185185185,1.2726747242794756,0.6827030913465135,0.52022957623482,0.7236600685623024
105,73,18,14,0,4,14,13.833333333333332,0.7685185185185185,2.5840759939543023,0.5975619241272507,0.6045985559938416,0.8166989525828044
47,33,13,10,0,3,10,9.838461538461539,0.7568047337278107,1.0248569548901645,0.7598671895040376,2.549638768046386,1.2467452069735663
3,2,17,13,0,4,13,12.841176470588236,0.755363321799308,2.106705410095059,0.5880728744492375,1.1397890016621939,1.1852959388139084
56,40,16,12,0,4,12,11.850000000000001,0.7406250000000001,2.6869194769854015,0.6153585635831059,0.7761221735685051,0.9444490464230425
86,57,16,12,0,4,12,11.850000000000001,0.7406250000000001,2.1340056706488695,0.63469754521958,0.5584779537096101,0.764913217768362
226,164,16,12,0,4,12,11.850000000000001,0.7406250000000001,2.6515207215097236,0.6510263915157785,0.4628412908799686,0.6801018239175652
70,47,12,9,0,3,9,8.850000000000001,0.7375000000000002,1.8035647715241976,0.7313111383966249,0.7672705836689299,0.9776625457318019
131,93,15,11,0,4,11,10.860000000000001,0.7240000000000001,2.383243558919623,0.6516727843397588,0.7027982282282719,0.9388902188133091
169,120,11,8,0,3,8,7.863636363636363,0.7148760330578512,2.1980149775338087,0.7029073135026107,1.3593418965649722,1.0749718625899949
8,6,18,13,0,5,13,12.866666666666667,0.7148148148148148,1.8221843085074658,0.5771849920122945,1.2108618966713016,1.218767940392855
46,32,14,10,0,4,10,9.871428571428572,0.7051020408163265,1.4777374188835088,0.6477009791161698,0.8904767612784783,1.0753888406314736
25,12,17,12,0,5,12,11.876470588235295,0.6986159169550173,1.6875803231119626,0.5836104127978814,0.4579972704126581,0.6089571255289612
155,113,17,12,0,5,12,11.876470588235295,0.6986159169550173,1.509523906166224,0.6117212797523228,8.444453911379318,1.093907502170186
220,159,7,5,0,2,5,4.871428571428571,0.6959183673469387,0.8409794718851673,1.0191764778513588,0.3161393135533359,0.4894707348010586
96,67,13,9,0,4,9,8.884615384615387,0.683431952662722,2.091588427204079,0.6918800703132617,0.5694465812840768,0.8006971469555519
45,31,16,11,0,5,11,10.887500000000001,0.6804687500000001,1.5791150669122405,0.5753317856758166,0.8064249562161394,0.9221746519634112
77,54,16,11,0,5,11,10.887500000000001,0.6804687500000001,2.076759934106078,0.6282158989278533,1.0224917389962542,1.1655964282878466
175,123,16,11,0,5,11,10.887500000000001,0.6804687500000001,1.540784006540916,0.5931955247159629,1.619108482360248,1.3156422632209046
23,10,15,10,0,5,10,9.9,0.66,1.2065823343759803,0.6279867869421101,0.692013997634891,0.8876021464093058
74,51,15,10,0,5,10,9.9,0.66,1.9217274406325116,0.612389288027442,0.9155536840484878,0.9355984325079226
135,96,12,8,0,4,8,7.9,0.6583333333333333,0.720507597087831,0.6959025017931713,2.3664265548877013,1.327441771684202
33,20,14,9,0,5,9,8.914285714285716,0.6367346938775512,0.8053689706325734,0.6749296334656465,2.0793121413539875,1.4537850454163832
115,81,14,9,0,5,9,8.914285714285716,0.6367346938775512,1.135764997324334,0.6688485182339772,1.2207455485553673,1.2301740562713377
168,119,14,9,0,5,9,8.914285714285716,0.6367346938775512,1.744049371158267,0.7203227945810278,3.8458611078449683,2.1047408779744763
108,74,16,10,0,6,10,9.925,0.6203125,2.0301038390187753,0.6075431448499112,0.48055378251525055,0.6447405269053055
124,88,16,10,0,6,10,9.925,0.6203125,1.8676227979515898,0.6006319501659043,0.8808793580458474,1.0050639521603717
192,134,16,10,0,6,10,9.925,0.6203125,1.9510698658951626,0.5776635695890211,2.245456325387195,1.9063542196610355
221,160,16,10,0,6,10,9.925,0.6203125,1.292564897566611,0.5784062165523843,1.0095683045737696,1.1054554139129442
21,8,13,8,0,5,8,7.930769230769231,0.6100591715976331,1.1012975888214134,0.7009719971736686,0.9634522103466422,1.0945621842272288
64,44,13,8,0,5,8,7.930769230769231,0.6100591715976331,0.007864335613973917,0.6651774660012815,0.7691607120362456,0.9894862359037667
73,50,13,8,0,5,8,7.930769230769231,0.6100591715976331,1.5552732603889168,0.6469054851716469,0.42656055519381925,0.5032768876908998
171,122,13,8,0,5,8,7.930769230769231,0.6100591715976331,0.08150681493336995,0.6197376733837723,0.598512143415326,0.6650371902053002
229,167,13,8,0,5,8,7.930769230769231,0.6100591715976331,0.4272507954852021,0.6658854596633609,1.08587629537883,1.1666198651917865
88,59,18,11,0,7,11,10.933333333333334,0.6074074074074074,0.8026545056399421,0.5915482573766963,1.0717714919447505,1.0256652557624268
104,72,20,12,0,8,12,11.94,0.597,0.8672951984137253,0.5113666784500789,0.9974164237928067,1.011923930658193
50,36,15,9,0,6,9,8.94,0.596,0.9470097878879353,0.5954276051858645,0.6919363415940947,0.7979790557132416
152,110,15,9,0,6,9,8.94,0.596,0.9916845694703116,0.6256544435506207,0.7522480784070272,0.9202147334927878
182,128,15,9,0,6,9,8.94,0.596,1.0185509183013044,0.6036774920356132,0.8422319805448777,1.0409212307091176
109,75,17,10,0,7,10,9.947058823529412,0.585121107266436,2.3131135740547224,0.5565433304793814,0.4743432109189383,0.5443132313558815
99,69,12,7,0,5,7,6.949999999999999,0.5791666666666666,0.5385268467476166,0.6913007942139148,0.4989197150881517,0.6361624598588803
207,146,12,7,0,5,7,6.949999999999999,0.5791666666666666,1.0688121055386273,0.6646470562828126,0.8099204038665282,0.8835482868963411
116,82,14,8,0,6,8,7.957142857142857,0.5683673469387756,0.8418234933904247,0.6227286722297606,0.6147386125386323,0.751729161711861
122,86,14,8,0,6,8,7.957142857142857,0.5683673469387756,1.2196938103456967,0.6350959194355436,0.7209254956495982,0.8832910132350648
140,99,14,8,0,6,8,7.957142857142857,0.5683673469387756,-0.912831422887569,0.6561486368362633,0.5479070475370302,0.7282656067999898
154,112,14,8,0,6,8,7.957142857142857,0.5683673469387756,1.307901602814362,0.6416107964240545,0.8426852703079263,0.8463183909937847
190,132,14,8,0,6,8,7.957142857142857,0.5683673469387756,0.6967506103123191,0.6932054732784075,0.7675615836003414,0.9578364865033937
71,48,16,9,0,7,9,8.9625,0.56015625,0.4799788205373768,0.593803899398149,0.9554624425992795,1.0461250061052314
137,98,16,9,0,7,9,8.9625,0.56015625,1.1762264076273432,0.582629346933185,0.5933232061898073,0.6395118866195779
206,145,16,9,0,7,9,8.9625,0.56015625,-1.1956636516673913,0.6659242798272492,2.180811446240251,1.5961016115935138
24,11,11,6,0,5,6,5.972727272727273,0.5429752066115703,0.22212667062827154,0.6690831632895762,1.3267852768593813,1.2566080544748417
37,24,13,7,0,6,7,6.976923076923076,0.5366863905325443,0.777173275178655,0.6801368567619112,0.3405558213977042,0.41676494293778266
39,26,13,7,0,6,7,6.976923076923076,0.5366863905325443,0.2617184543155611,0.6210786646240927,1.2492962530067222,1.1971933958282581
125,89,13,7,0,6,7,6.976923076923076,0.5366863905325443,0.1039436087854247,0.6494814664642768,1.0259923041382362,0.9371231101811032
200,140,13,7,0,6,7,6.976923076923076,0.5366863905325443,0.576379231806253,0.6398073165527743,0.5914189163058636,0.7276385141220738
225,163,13,7,0,6,7,6.976923076923076,0.5366863905325443,0.5223879949174856,0.6401837835632472,1.257795199239054,1.2062194740639451
32,19,15,8,0,7,8,7.98,0.532,0.6877646236584386,0.6056326893910726,0.8548876069271358,0.9936137323468928
49,35,15,8,0,7,8,7.98,0.532,-0.6264804298814308,0.5692770773658935,0.7666855676977178,0.8505321361461662
55,39,15,8,0,7,8,7.98,0.532,0.3549146223244073,0.5797651918306986,0.6360826389147041,0.6725050568353588
92,63,15,8,0,7,8,7.98,0.532,0.6051082525187826,0.5852529855158811,0.9457929772447059,1.0037443684927216
110,76,15,8,0,7,8,7.98,0.532,0.11667290420158435,0.5832633422934761,0.6908677422774846,0.7973152201332633
119,83,15,8,0,7,8,7.98,0.532,0.729699098310179,0.5488790153710656,0.9518440911042195,0.9843398653631308
230,168,15,8,0,7,8,7.98,0.532,0.15354397828024455,0.568783507600362,1.6497837191933202,1.468951303097261
28,15,17,9,0,8,9,8.98235294117647,0.5283737024221453,0.4427909094521922,0.5578618550015778,1.4410450599734566,0.937991726915522
65,45,17,9,0,8,9,8.98235294117647,0.5283737024221453,0.23203525315931572,0.5341673828128343,0.6992070838521041,0.7887839944534812
93,64,17,9,0,8,9,8.98235294117647,0.5283737024221453,-0.47493711469079475,0.5839901987700928,0.6519333347337491,0.78759795187969
27,14,12,6,0,6,6,6,0.5,0.9757684228750741,0.6618677679803852,0.4620637132319028,0.5363678369712803
29,16,14,7,0,7,7,7,0.5,0.22567768454903933,0.5932594887459878,0.7498672226581556,0.8345746609149445
87,58,14,7,0,7,7,7,0.5,0.40306880359436553,0.5723190678720594,0.7894279031627323,0.8478556907497763
90,61,14,7,0,7,7,7,0.5,-0.7393654354773328,0.6852890087441142,0.6406514727263525,0.862975807592819
120,84,14,7,0,7,7,7,0.5,0.052973370824602656,0.5929896584566424,1.5438250842065193,1.4283892311610173
121,85,12,6,0,6,6,6,0.5,1.035068379224722,0.6381301528303287,0.8852802877621126,0.8946150810265683
132,94,14,7,0,7,7,7,0.5,1.084371132196204,0.6161342086382654,1.1196669824971748,1.0121482524802803
136,97,16,8,0,8,8,8,0.5,1.0828084740671813,0.6065104186336566,0.6304740974061287,0.7809649108959648
193,135,14,7,0,7,7,7,0.5,0.46647130705427464,0.5904532213514889,0.8224963278074239,0.8862517796900183
214,153,14,7,0,7,7,7,0.5,-1.5845477679204416,0.5988007056951684,0.9427803881080782,1.042296273778251
224,162,18,9,0,9,9,9,0.5,1.1569352710820267,0.5658052777542939,0.6004560137308868,0.7316063358806921
227,165,14,7,0,7,7,7,0.5,0.695420183054539,0.6088748047086204,0.7894696342858438,0.8507963285997594
38,25,17,8,0,9,8,8.01764705882353,0.4716262975778547,0.23355696283237193,0.5528713299753679,1.1145732324781163,1.069463725960231
103,71,17,8,0,9,8,8.01764705882353,0.4716262975778547,-0.017318861880700823,0.554752873721303,0.9598328890895674,1.0903160453854777
198,138,17,8,0,9,8,8.01764705882353,0.4716262975778547,-0.09498118609068468,0.5621215501174998,0.5968676511367876,0.688792393842772
201,141,17,8,0,9,8,8.01764705882353,0.4716262975778547,0.12882091779240526,0.5536373798388438,0.6715244992693028,0.8086518366982532
20,7,15,7,0,8,7,7.02,0.46799999999999997,-2.070374326415847,0.6320691256750017,0.6706893820581691,0.8704496371643696
26,13,15,7,0,8,7,7.02,0.46799999999999997,-0.35310003347480623,0.6200901557361471,0.7881923308163449,0.8463899175547674
89,60,15,7,0,8,7,7.02,0.46799999999999997,0.5235876100909141,0.6149711523217647,0.6073709235086964,0.7975495705969736
102,70,15,7,0,8,7,7.02,0.46799999999999997,0.595903262662874,0.5791647157480255,0.579913734511313,0.649986042546956
144,103,15,7,0,8,7,7.02,0.46799999999999997,-1.6557785959734401,0.5791846817869515,0.7257842072068025,0.8320558813367841
43,29,13,6,0,7,6,6.023076923076923,0.4633136094674556,-0.6934002171118426,0.6616579991493381,0.5007755067192218,0.6437825077203244
97,68,13,6,0,7,6,6.023076923076923,0.4633136094674556,0.6843988731858386,0.6504746442759217,0.8469429183210109,0.8976294885600955
123,87,13,6,0,7,6,6.023076923076923,0.4633136094674556,-0.24592839418805887,0.6406560960915254,1.5344165538578014,1.2733289622101582
142,101,13,6,0,7,6,6.023076923076923,0.4633136094674556,0.002342072135660791,0.6677070185916636,1.5659063461837128,1.3546969923546541
170,121,13,6,0,7,6,6.023076923076923,0.4633136094674556,0.42495232246149617,0.6505428766140822,0.7922673004619296,0.860460227684114
48,34,11,5,0,6,5,5.027272727272727,0.4570247933884298,-0.1112415169413147,0.7037284045039057,0.8467084821498385,0.9706023306086512
151,109,11,5,0,6,5,5.027272727272727,0.4570247933884298,-1.1831410599333794,0.7223023287832081,1.1278501904632103,1.1307616986536382
52,37,9,4,0,5,4,4.033333333333333,0.44814814814814813,0.4908542913076275,0.7117535040588278,0.6366102132382943,0.6557462013876867
4,3,16,7,0,9,7,7.0375,0.43984375,0.3104016230528468,0.5705913686796482,1.0309529310873309,1.1104039979200264
75,52,16,7,0,9,7,7.0375,0.43984375,0.4398665636749668,0.593758652604863,0.8509712711597672,0.8939407124139063
147,106,14,6,0,8,6,6.042857142857143,0.4316326530612245,-1.2702353300500582,0.6651798174729597,0.6487670482383626,0.7922259223845529
176,124,14,6,0,8,6,6.042857142857143,0.4316326530612245,-0.2930788283358768,0.5881744118389595,0.8162133858601738,0.892308660707331
141,100,19,8,0,11,8,8.047368421052632,0.42354570637119116,1.1636915880005019,0.5196459445462386,0.8155388498939908,0.8380262872203401
6,4,12,5,0,7,5,5.05,0.42083333333333334,0.3589259559631253,0.6791522470734381,0.8642000324003076,1.056928045569406
53,38,12,5,0,7,5,5.05,0.42083333333333334,-0.9040994829088209,0.7845936635739122,0.40078401945537073,0.5995562241486534
78,55,12,5,0,7,5,5.05,0.42083333333333334,-1.0313350030301682,0.7351535418349433,0.508727923841629,0.6995510493842743
211,150,12,5,0,7,5,5.05,0.42083333333333334,-1.1689402447357824,0.662241725490013,0.5598680994200067,0.6846176865954066
95,66,17,7,0,10,7,7.052941176470587,0.41487889273356393,-0.8332807194151381,0.5948022672417134,0.5274507175582961,0.6463593153306054
114,80,17,7,0,10,7,7.052941176470587,0.41487889273356393,-0.46491902498765303,0.5731342582007114,0.5011943717637016,0.611101424918354
134,95,10,4,0,6,4,4.0600000000000005,0.406,-0.5562829345313194,0.7548305620383309,0.7920267276241462,0.9045632196735498
35,22,15,6,0,9,6,6.0600000000000005,0.404,-0.07247413208073299,0.6201466251452723,0.6877515274036318,0.8924546074904273
36,23,15,6,0,9,6,6.0600000000000005,0.404,-0.9893886972151928,0.6449278960579036,0.9034103249689682,1.0251354098210128
76,53,15,6,0,9,6,6.0600000000000005,0.404,-0.3593923536801927,0.5741679207370456,1.2590288575196502,1.2088100279403524
181,127,15,6,0,9,6,6.0600000000000005,0.404,-1.6316821398694887,0.633967041483189,0.4598146879815237,0.6137267247129863
187,130,15,6,0,9,6,6.0600000000000005,0.404,-1.1163184922075826,0.6639040114447199,0.5318867892138236,0.7284397340056441
7,5,13,5,0,8,5,5.069230769230769,0.3899408284023668,-0.7374599992253398,0.671027829997685,1.2669907134442566,1.460414592023583
91,62,13,5,0,8,5,5.069230769230769,0.3899408284023668,-0.10629010480871168,0.6781250617029583,0.876900891834655,1.0569083580444498
113,79,13,5,0,8,5,5.069230769230769,0.3899408284023668,-0.5404048741547699,0.677801165408071,0.4535275585757591,0.5977484154294144
149,108,13,5,0,8,5,5.069230769230769,0.3899408284023668,-0.3669746059681682,0.6078850228977896,0.9829721630834295,0.9499875775696939
223,161,11,4,0,7,4,4.081818181818182,0.37107438016528926,-1.9814453407246677,0.7492655251753897,2.043174126568004,1.1900354674511178
57,41,14,5,0,9,5,5.085714285714285,0.36326530612244895,-0.8916315981822608,0.598720751044027,1.0192407603365512,1.0935033258238074
58,42,14,5,0,9,5,5.085714285714285,0.36326530612244895,-0.962342855616684,0.8491092801236941,1.9266753651916797,1.6734892496628575
145,104,14,5,0,9,5,5.085714285714285,0.36326530612244895,-1.5123765379463001,0.6630172988822197,0.5075455807287446,0.6987454035687992
180,126,14,5,0,9,5,5.085714285714285,0.36326530612244895,0.17565161014330583,0.5778572085778452,0.8876022822157371,0.9263087736430007
208,147,14,5,0,9,5,5.085714285714285,0.36326530612244895,-1.8371908634074612,0.6885427449902107,0.5136388383982766,0.6712876924521864
195,137,17,6,0,11,6,6.088235294117647,0.35813148788927335,-0.051711589100043275,0.5922452742554917,0.4407756786646808,0.5535612536635743
203,143,17,6,0,11,6,6.088235294117647,0.35813148788927335,-1.255092921549036,0.5923716394693933,0.5367160930885446,0.6964687977743462
22,9,12,4,0,8,4,4.1000000000000005,0.34166666666666673,-1.3992858058260451,0.7492548536453458,2.255488812216749,0.9823300075188591
69,46,12,4,0,8,4,4.1000000000000005,0.34166666666666673,-1.1263372111964807,0.7019835044883195,0.7753069037153174,0.9745554460624755
143,102,12,4,0,8,4,4.1000000000000005,0.34166666666666673,-0.987888938390735,0.6985977399112832,1.1122994965631623,1.1137763410244612
112,78,15,5,0,10,5,5.1,0.33999999999999997,-0.7057802302676566,0.6141378488268786,1.2591011260890566,1.2984534151239409
130,92,15,5,0,10,5,5.1,0.33999999999999997,-0.5026351322045726,0.5996819483756224,0.8661234877426538,1.0227565908939575
157,114,15,5,0,10,5,5.1,0.33999999999999997,-2.6023727943993467,0.6580135072548042,1.2525463434926283,1.353213463924531
205,144,15,5,0,10,5,5.1,0.33999999999999997,-1.538248948118996,0.6233008133490769,0.713589020312899,0.9387873275076181
34,21,16,5,0,11,5,5.1125,0.31953125,-2.6549805641418955,0.6771862327804913,0.7003676297893391,0.8577085022817925
148,107,16,5,0,11,5,5.1125,0.31953125,-3.090043688930582,0.7003273646269743,0.4524692028855021,0.675087367480605
199,139,16,5,0,11,5,5.1125,0.31953125,-1.0001280674833586,0.5969603787244036,1.1033445461414921,1.1591434548067086
218,157,16,5,0,11,5,5.1125,0.31953125,-0.5062059397021705,0.6164516572307237,0.47331606156484596,0.6203073890993559
2,1,13,4,0,9,4,4.115384615384616,0.31656804733727817,-2.4210207018133407,0.7004063704818283,0.5328265509217817,0.7361448743240517
44,30,13,4,0,9,4,4.115384615384616,0.31656804733727817,-1.6774683737941778,0.7568754402768065,0.429648769619108,0.6715624450546457
128,91,13,4,0,9,4,4.115384615384616,0.31656804733727817,-0.3071540410296116,0.6569878915831611,0.859602061631739,0.979141605722183
209,148,13,4,0,9,4,4.115384615384616,0.31656804733727817,-0.719483608433162,0.7470740846962337,1.9792377204358884,1.4751134237067547
212,151,13,4,0,9,4,4.115384615384616,0.31656804733727817,-2.4586382375532145,0.6690237177068189,0.48818231429138265,0.6435979841382569
213,152,17,5,0,12,5,5.1235294117647054,0.30138408304498265,-2.2754431683138754,0.703123162903746,3.8675402024212104,2.4135715835294516
191,133,14,4,0,10,4,4.128571428571429,0.2948979591836735,-1.2866045902975989,0.7306062855131306,0.34553328660474497,0.5092840422391653
79,56,11,3,0,8,3,3.1363636363636362,0.28512396694214875,-1.7561753307361543,0.8198858525199472,0.60619848720218,0.899977888911419
111,77,11,3,0,8,3,3.1363636363636362,0.28512396694214875,-2.6464961178253796,0.7465440851778149,0.5408997568445474,0.739565774428319
163,116,15,4,0,11,4,4.140000000000001,0.276,-1.7727437253112697,0.6484407178291269,0.9969899610665299,1.056973038238677
30,17,12,3,0,9,3,3.15,0.2625,-4.312605496142912,0.7059722185624665,1.365087674076574,1.3387723738110193
94,65,12,3,0,9,3,3.15,0.2625,-3.4226527550843495,0.8313873657946345,1.7013498551393857,1.7945369054593228
194,136,12,3,0,9,3,3.15,0.2625,-0.8884819136367563,0.7214161255296607,0.4691514440271824,0.5817612665545446
216,155,14,3,0,11,3,3.1714285714285713,0.22653061224489796,-3.29931903672217,0.7512035639351048,0.4577260330577375,0.7437790852432536
217,156,14,3,0,11,3,3.1714285714285713,0.22653061224489796,-2.9738664581850727,0.8393999656109024,0.20176125462709193,0.3888318628086105
41,28,15,3,0,12,3,3.18,0.21200000000000002,-3.389188389198188,0.7255004795758442,9.327818905803664,1.1610334250572631
219,158,15,3,0,12,3,3.18,0.21200000000000002,-1.6679113603532019,0.8026932496776532,0.28281070185507545,0.5119681814484983
202,142,16,3,0,13,3,3.1875,0.19921875,-4.122816782496559,0.7337389166347351,0.27241883554273794,0.5087189652849892
179,125,17,3,0,14,3,3.1941176470588233,0.18788927335640138,-3.563462627613672,0.7216697688022621,0.4821327194617407,0.8628890496880685
159,115,13,2,0,11,2,2.207692307692308,0.1698224852071006,-4.4131164435408445,0.8283630988786209,0.4618508762351388,0.8626514455154207
210,149,13,2,0,11,2,2.207692307692308,0.1698224852071006,-2.918539899940039,0.778232530986505,0.5120748172218467,0.7823393079778903
184,129,14,2,0,12,2,2.2142857142857144,0.15816326530612246,-2.222500786170136,0.7638908243498326,1.4065329360540262,1.077044064535485
189,131,14,2,0,12,2,2.2142857142857144,0.15816326530612246,-2.830843415174625,0.7979590946118548,0.37431956910110387,0.6982869816932578
164,117,12,1,0,11,1,1.25,0.10416666666666667,-4.338821515555158,1.0678742335136753,0.16198554420432457,0.43918514891670374
