individual,id,Ntot,N1,ND,N0,raw,score,propscore,theta,se.theta,outfit,infit
995,995,14,14,0,0,14,13.700000000000001,0.9785714285714286,9.082106194843524,1.918639119654737,0.023689858441573862,0.10321885156163678
996,996,14,14,0,0,14,13.700000000000001,0.9785714285714286,8.52242706198429,2.0103631663214716,0.026224320786832477,0.21133326995122503
980,980,13,13,0,0,13,12.700000000000003,0.9769230769230771,8.807077628197224,1.9479086818023834,0.026413303929140097,0.13716443572192122
874,874,20,19,0,1,19,18.73,0.9365,8.203573712381775,0.9576070998372557,0.2633917009573572,0.7152695755467117
974,974,18,17,0,1,17,16.73333333333333,0.9296296296296295,8.867631947571951,1.0577738361979658,0.16609709954084376,0.7172742978784936
967,967,16,15,0,1,15,14.7375,0.92109375,4.133771292248372,0.9424061096949002,1.2784462600189865,0.9198316762103022
977,977,16,15,0,1,15,14.7375,0.92109375,5.971360224747342,0.9859762868717422,0.16443463369196376,0.46329976916311427
592,592,14,13,0,1,13,12.742857142857146,0.9102040816326532,8.41020113620121,1.0980630556838245,0.20579858515150726,0.7690662869813614
733,733,14,13,0,1,13,12.742857142857146,0.9102040816326532,5.392722607106471,0.9932974859190488,688.5864461165751,1.2256386337171774
938,938,14,13,0,1,13,12.742857142857146,0.9102040816326532,5.546309362971773,0.9805754602202107,2.214033432137802,1.1060981871044344
957,957,14,13,0,1,13,12.742857142857146,0.9102040816326532,5.472594601427196,0.9835789841470749,0.2319690772445787,0.5703985993646821
606,606,13,12,0,1,12,11.746153846153847,0.9035502958579882,4.137432555172501,1.0323849055766492,0.784624942712804,1.1778944138666656
937,937,13,12,0,1,12,11.746153846153847,0.9035502958579882,7.307912185091407,1.3956598562701739,0.05770328381126034,0.20448410019017704
928,928,18,16,0,2,16,15.766666666666666,0.8759259259259259,6.984052866246977,0.7854410940013177,0.4754930334937833,0.9739361735105521
929,929,18,16,0,2,16,15.766666666666666,0.8759259259259259,7.981772574097318,0.9097778013804403,1.108028886778891,1.2384450703340268
818,818,16,14,0,2,14,13.775,0.8609375,3.5796681984008556,0.7945034360397227,0.25289908643531905,0.5237882238465963
869,869,16,14,0,2,14,13.775,0.8609375,6.0184017173390325,0.7618271485263431,0.4500486263789224,0.784764615570878
962,962,16,14,0,2,14,13.775,0.8609375,3.5519047620096544,0.7553367597216261,0.5870046649517098,0.8768228224450593
986,986,16,14,0,2,14,13.775,0.8609375,6.301557040301366,0.8414887049895338,9.630308919843252,1.3267057889895675
997,997,22,19,0,3,19,18.78181818181818,0.8537190082644628,8.315734257222472,0.7225155763254135,51.28240443423394,1.0348091127505157
531,531,14,12,0,2,12,11.785714285714286,0.8418367346938777,2.986547536801389,0.7991659167618586,1.0365789502702119,0.9209373033915321
545,545,14,12,0,2,12,11.785714285714286,0.8418367346938777,4.791787229149739,0.9444038925218164,0.4758857219169353,0.8598157079582838
649,649,14,12,0,2,12,11.785714285714286,0.8418367346938777,4.202589575334182,0.8495523354009773,0.3339155407360331,0.6641267443410025
831,831,14,12,0,2,12,11.785714285714286,0.8418367346938777,4.256218604799604,0.8682875716430003,0.6133206475055389,1.331316802228412
875,875,14,12,0,2,12,11.785714285714286,0.8418367346938777,3.915973523070793,0.7804293769134995,0.5608010381762483,0.8739162031573313
976,976,14,12,0,2,12,11.785714285714286,0.8418367346938777,6.502290282517975,0.8877078767137784,0.19626825033871467,0.44997855763852124
985,985,14,12,0,2,12,11.785714285714286,0.8418367346938777,3.9701711340910535,0.8343209943150783,0.6044397538514735,0.9557027472693146
993,993,14,12,0,2,12,11.785714285714286,0.8418367346938777,6.777008069393142,0.9576695481333747,0.23121088483421706,0.6262387879788871
926,926,13,11,0,2,11,10.792307692307693,0.8301775147928995,4.210656286249455,1.6658467676041577,0.030866199474418772,0.05496698386206275
991,991,24,20,0,4,20,19.8,0.8250000000000001,3.4016409861114325,0.5675048325106862,15.082094287302388,1.0520586864603751
827,827,18,15,0,3,15,14.8,0.8222222222222223,4.974413373413512,0.678324747667675,0.7491103235957135,0.9670786411465738
798,798,17,14,0,3,14,13.805882352941175,0.8121107266435985,6.14988452928554,0.7383552396295838,0.4642408847307718,0.8625643700304466
865,865,17,14,0,3,14,13.805882352941175,0.8121107266435985,3.093823267026345,0.6838460090390059,0.5000634321985908,0.8428327378168153
206,206,16,13,0,3,13,12.812500000000002,0.8007812500000001,4.351667535039287,0.7234960275803701,0.3224781666340776,0.5816572355413759
732,732,16,13,0,3,13,12.812500000000002,0.8007812500000001,3.6876835071798766,0.6725817384467357,0.5630681414203481,0.842380013982654
842,842,16,13,0,3,13,12.812500000000002,0.8007812500000001,6.511505087380506,0.8030005230122688,0.2676600539080349,0.5965166415374814
921,921,16,13,0,3,13,12.812500000000002,0.8007812500000001,4.413085204191394,0.6939764179614991,7.869406959202793,0.9893097885354597
655,655,24,19,0,5,19,18.825,0.7843749999999999,4.499898748850257,0.544536579319875,0.8825502068254575,1.0677755979993946
951,951,19,15,0,4,15,14.826315789473686,0.7803324099722992,3.5660125879545634,0.6026397388413753,0.572530400930242,0.8444452128667417
955,955,19,15,0,4,15,14.826315789473686,0.7803324099722992,3.3768345315444246,0.6316734179862233,0.882356342188671,1.0896799011556186
333,333,14,11,0,3,11,10.82857142857143,0.7734693877551021,3.2688541339133,0.7073518995463625,0.5945360429296721,0.8380929252433239
454,454,14,11,0,3,11,10.82857142857143,0.7734693877551021,4.239072120498239,0.7586692963356327,0.5650617235930518,0.9606382905562436
492,492,14,11,0,3,11,10.82857142857143,0.7734693877551021,3.141930554583874,0.8038014835257665,1.037998166856425,0.9004463070501667
609,609,14,11,0,3,11,10.82857142857143,0.7734693877551021,1.4830115255108804,0.6852906858674563,0.465745142059851,0.6038009604245393
640,640,14,11,0,3,11,10.82857142857143,0.7734693877551021,4.221135028368933,0.7209867670814182,0.4844435885946062,0.7059747282460151
682,682,14,11,0,3,11,10.82857142857143,0.7734693877551021,4.451825622822026,0.7153662980890104,0.5767859121198422,0.9447230324178507
694,694,14,11,0,3,11,10.82857142857143,0.7734693877551021,4.138271768160789,0.7252753565452699,4.235218935815503,1.3311739387202546
710,710,14,11,0,3,11,10.82857142857143,0.7734693877551021,1.7690162769381657,0.7463309221713563,1.39030954075715,0.8614722080013241
738,738,14,11,0,3,11,10.82857142857143,0.7734693877551021,1.5096397450841974,0.6887197871601438,2.0862039271651125,1.2235841399516203
747,747,14,11,0,3,11,10.82857142857143,0.7734693877551021,7.2968085419738005,0.9261477247696763,0.1364179423492296,0.2751565464258497
749,749,14,11,0,3,11,10.82857142857143,0.7734693877551021,2.409819724511873,0.782243857118133,3.143404617196599,1.2908271957271025
754,754,14,11,0,3,11,10.82857142857143,0.7734693877551021,1.9034389611322475,0.7209253813172484,0.38773081882377264,0.5738757335468997
860,860,14,11,0,3,11,10.82857142857143,0.7734693877551021,3.7476868581053426,0.7705033974754347,0.29347365881673176,0.5151237383157816
882,882,14,11,0,3,11,10.82857142857143,0.7734693877551021,4.849916964523224,0.7925720870923388,3.013611922391399,1.50165071317272
896,896,14,11,0,3,11,10.82857142857143,0.7734693877551021,1.718457379084617,0.7046621083981518,2.1575729941205113,1.016555813550794
913,913,14,11,0,3,11,10.82857142857143,0.7734693877551021,3.058432485889813,0.7562583527332821,0.3819980618901348,0.6907592733539595
942,942,14,11,0,3,11,10.82857142857143,0.7734693877551021,4.701972144418007,0.7837211124219778,0.5239354400810924,0.968690291268022
982,982,14,11,0,3,11,10.82857142857143,0.7734693877551021,3.4866824509859664,0.6701817126281938,0.9301832591131506,1.073155763667761
270,270,18,14,0,4,14,13.833333333333332,0.7685185185185185,1.4741972316959988,0.600425047803977,0.6459392866394629,0.9189603077991245
936,936,18,14,0,4,14,13.833333333333332,0.7685185185185185,2.5632420334792934,0.6714521953185066,0.9222126854968431,1.1836699661130257
968,968,18,14,0,4,14,13.833333333333332,0.7685185185185185,1.6393562338413816,0.694158958739329,3.8307013746703102,1.236762006844032
641,641,26,20,0,6,20,19.83846153846154,0.7630177514792901,2.508761799219434,0.518761305655744,0.5008726418019971,0.7639373354442592
20,20,13,10,0,3,10,9.838461538461539,0.7568047337278107,2.8793962358331986,0.7194974271952743,0.4927128160354851,0.7730029211186592
433,433,13,10,0,3,10,9.838461538461539,0.7568047337278107,2.0886365679929164,0.7224399190382962,1.4993130475219074,1.1448349079196645
658,658,13,10,0,3,10,9.838461538461539,0.7568047337278107,5.002848593618624,0.8604807082957403,0.6575700635452678,1.1379573866459254
667,667,13,10,0,3,10,9.838461538461539,0.7568047337278107,1.7792671213066908,0.8611925623474211,1.8024496042674265,1.049944988487928
953,953,13,10,0,3,10,9.838461538461539,0.7568047337278107,5.151926108003646,1.4232613365778328,3.3487243583988766,3.7505657361359046
972,972,13,10,0,3,10,9.838461538461539,0.7568047337278107,2.992638760592931,0.7787628112778969,1.3986977060041534,1.7484697329114427
469,469,17,13,0,4,13,12.841176470588236,0.755363321799308,3.184618706385835,0.6968676695748068,0.4945027365095928,0.8833596812698523
625,625,20,15,0,5,15,14.850000000000001,0.7425,2.729075716612999,0.566718568368246,2.3333958399821553,1.0701936406039616
2,2,16,12,0,4,12,11.850000000000001,0.7406250000000001,3.3757321278943335,0.6226410289010091,0.7877965553464895,1.0572181949814377
5,5,16,12,0,4,12,11.850000000000001,0.7406250000000001,2.5306780921592695,0.6426359547278886,0.5504252834954766,0.8137170501417059
280,280,16,12,0,4,12,11.850000000000001,0.7406250000000001,3.2731716525734984,0.6569441864400677,0.4591668195061258,0.7140388047939438
605,605,16,12,0,4,12,11.850000000000001,0.7406250000000001,3.858792109336553,0.6660591643883979,0.636159451629195,0.961956238637974
689,689,16,12,0,4,12,11.850000000000001,0.7406250000000001,3.540752997850391,0.64378327298231,0.6074704794888515,0.9079006215850797
703,703,16,12,0,4,12,11.850000000000001,0.7406250000000001,6.811850959654376,0.8700948293149673,0.5848241162712975,1.1379590799272372
734,734,16,12,0,4,12,11.850000000000001,0.7406250000000001,6.956215228326197,0.8684874454434495,0.1466506019072088,0.32096184692966956
735,735,16,12,0,4,12,11.850000000000001,0.7406250000000001,1.3326848964270317,0.7458249704230209,0.5245484539859582,0.6741006183242229
744,744,16,12,0,4,12,11.850000000000001,0.7406250000000001,5.0567228255194605,0.7035947940749065,0.53853934577561,0.9172271911825948
776,776,16,12,0,4,12,11.850000000000001,0.7406250000000001,3.6312062846659217,0.6706070473317827,3.735003474115243,1.0757593202219444
778,778,16,12,0,4,12,11.850000000000001,0.7406250000000001,0.09560342842807722,0.5865710629935789,1.1773743692071146,1.0828505405916438
825,825,16,12,0,4,12,11.850000000000001,0.7406250000000001,2.003423848980196,0.6612984854256437,0.5073941320030809,0.7801911617704258
844,844,16,12,0,4,12,11.850000000000001,0.7406250000000001,3.5747345992376656,0.657436570152763,0.7346641991327695,0.9379332242996344
885,885,16,12,0,4,12,11.850000000000001,0.7406250000000001,5.649897415781219,0.6208662999597709,0.8944988291403762,0.9866728456022563
909,909,16,12,0,4,12,11.850000000000001,0.7406250000000001,2.8505779513300484,0.629472803130252,1.9840088103070728,1.0836661360275435
910,910,16,12,0,4,12,11.850000000000001,0.7406250000000001,2.7721610513444213,0.6626578002614789,0.45151607233127095,0.6712088101372331
922,922,16,12,0,4,12,11.850000000000001,0.7406250000000001,4.8982826092821155,0.7191832195952478,0.7416201768890982,1.1028573770159025
973,973,16,12,0,4,12,11.850000000000001,0.7406250000000001,5.063362303956005,0.8619836369373213,0.26899282965103,0.6644984687808547
714,714,19,14,0,5,14,13.857894736842104,0.7293628808864265,2.3743235950580908,0.5629579284932326,0.8423887990308465,1.0311260198457697
7,7,18,13,0,5,13,12.866666666666667,0.7148148148148148,1.8763725584377737,0.5540317171976121,1.8329763983937797,1.44061979233069
294,294,18,13,0,5,13,12.866666666666667,0.7148148148148148,0.7166936087222893,0.5982442398912765,0.4696933307465668,0.6145487295389619
521,521,18,13,0,5,13,12.866666666666667,0.7148148148148148,0.5400699687477921,0.7229688252559467,1.29417991122937,1.0098578179232485
782,782,18,13,0,5,13,12.866666666666667,0.7148148148148148,0.7020641094098902,0.612493905672014,0.6812561205116984,0.9301991982138198
884,884,18,13,0,5,13,12.866666666666667,0.7148148148148148,4.096506904098485,0.5987010517667134,0.5897618967930972,0.803306949609859
923,923,18,13,0,5,13,12.866666666666667,0.7148148148148148,3.3409726558356425,0.6185612459240725,0.7828854030011716,0.9921654276570014
930,930,18,13,0,5,13,12.866666666666667,0.7148148148148148,4.190926325516791,0.5716119673551808,0.6040932802435143,0.7203232208465539
969,969,18,13,0,5,13,12.866666666666667,0.7148148148148148,6.204472164343876,0.6875883230290708,0.48602050242536915,0.7806067713827799
994,994,18,13,0,5,13,12.866666666666667,0.7148148148148148,3.9633486275250376,0.6472455984100308,0.44213206738931166,0.7934793317593523
3,3,14,10,0,4,10,9.871428571428572,0.7051020408163265,2.1369077240965324,0.6503075709135206,1.6741440419604285,1.2648512739581854
163,163,14,10,0,4,10,9.871428571428572,0.7051020408163265,0.9429663639478291,0.738611667943951,0.5427775377285979,0.733790093584018
207,207,14,10,0,4,10,9.871428571428572,0.7051020408163265,3.07436737062238,0.6759526435426975,0.5549012010056875,0.7403158315372497
355,355,14,10,0,4,10,9.871428571428572,0.7051020408163265,2.2682854716640697,0.7195362796030232,0.3955852835395293,0.6385896250587602
361,361,14,10,0,4,10,9.871428571428572,0.7051020408163265,1.4543267366007886,0.6970895848856076,0.7454289459742929,0.6864485851750713
449,449,14,10,0,4,10,9.871428571428572,0.7051020408163265,3.6330056283767527,0.6997618366613243,0.5268679200197555,0.7810465189511145
461,461,14,10,0,4,10,9.871428571428572,0.7051020408163265,1.4135941876641451,0.6509794458012043,0.57152983123361345,0.7675875497752106
462,462,14,10,0,4,10,9.871428571428572,0.7051020408163265,1.729805544767882,0.7096828477479078,0.6198517045828927,0.8041648874239411
528,528,14,10,0,4,10,9.871428571428572,0.7051020408163265,2.172802371600281,0.65035773844382,0.5155009556800755,0.6882493035431457
529,529,14,10,0,4,10,9.871428571428572,0.7051020408163265,1.781688592792768,0.6554825580247744,0.7440341176098482,0.9481835298207516
551,551,14,10,0,4,10,9.871428571428572,0.7051020408163265,3.3088713594766173,0.6745229804357927,1.4628565040184955,1.4003386522951078
557,557,14,10,0,4,10,9.871428571428572,0.7051020408163265,2.1585940619340507,0.6730029613991867,1.2888964587983798,1.1221052750317126
585,585,14,10,0,4,10,9.871428571428572,0.7051020408163265,2.740255570176904,0.6873531603543669,0.9970570130367086,1.2440315071335806
589,589,14,10,0,4,10,9.871428571428572,0.7051020408163265,3.4407782595175456,0.7437649223049448,0.375684974540832,0.660651899302977
633,633,14,10,0,4,10,9.871428571428572,0.7051020408163265,1.7421259088640193,0.6828988015765235,0.7127832530849058,0.9239587102768516
656,656,14,10,0,4,10,9.871428571428572,0.7051020408163265,1.302164089052166,0.7334060768298263,1.2506376536844825,1.3023794377919478
663,663,14,10,0,4,10,9.871428571428572,0.7051020408163265,3.4799624401930243,0.7349613598442369,2.042352084960194,1.1285292215236447
727,727,14,10,0,4,10,9.871428571428572,0.7051020408163265,3.527761057960401,0.7238537021348419,5.935308585204175,1.2762096895226824
753,753,14,10,0,4,10,9.871428571428572,0.7051020408163265,2.9860130740465602,0.7278194107538054,0.8839504943428327,1.2781048555773427
755,755,14,10,0,4,10,9.871428571428572,0.7051020408163265,1.196337225739103,0.6647642792116276,0.5050094114913881,0.6174207709790712
762,762,14,10,0,4,10,9.871428571428572,0.7051020408163265,4.10603523850416,0.7662516352826619,0.5233667635168434,0.927616472884507
807,807,14,10,0,4,10,9.871428571428572,0.7051020408163265,2.4181957875860407,0.7983214670518528,2.709639662982752,1.1402051851062902
846,846,14,10,0,4,10,9.871428571428572,0.7051020408163265,2.7072391927983173,0.76379283899163,0.5579506578900447,0.9960605274182924
890,890,14,10,0,4,10,9.871428571428572,0.7051020408163265,2.6892952944201283,0.8229567994294741,0.1944391866804336,0.33946646629468114
892,892,14,10,0,4,10,9.871428571428572,0.7051020408163265,5.6847244434418025,0.8213032757338595,0.29885725303080174,0.6148285649840037
907,907,14,10,0,4,10,9.871428571428572,0.7051020408163265,5.992976262725118,0.8966821827125256,0.17196980479718857,0.37443770791333153
914,914,14,10,0,4,10,9.871428571428572,0.7051020408163265,2.475536180313333,0.7245652249784298,0.4351474141156833,0.6372485903289152
918,918,14,10,0,4,10,9.871428571428572,0.7051020408163265,5.300923696327851,0.7810785617605984,0.4258780782162993,0.7867971710875661
935,935,14,10,0,4,10,9.871428571428572,0.7051020408163265,3.304678469691551,0.7210894586096077,0.39499820933534524,0.6469134134411678
944,944,14,10,0,4,10,9.871428571428572,0.7051020408163265,2.785784701593625,0.696054174808909,0.9942628675817444,1.2385042799852228
950,950,14,10,0,4,10,9.871428571428572,0.7051020408163265,3.5092770108126135,0.6796705716342983,0.4181526454465915,0.6124640532499422
966,966,14,10,0,4,10,9.871428571428572,0.7051020408163265,1.8733866948188183,0.7293290007216744,0.8959386639181116,1.288428155101994
970,970,14,10,0,4,10,9.871428571428572,0.7051020408163265,3.3378282350000017,0.6975057104092438,0.6508767094702839,0.922563386281573
971,971,14,10,0,4,10,9.871428571428572,0.7051020408163265,5.6070987936009695,0.8726251002429586,0.651295575318536,1.187559651334364
989,989,14,10,0,4,10,9.871428571428572,0.7051020408163265,4.599790842902253,0.8051439464593593,0.19202995027843506,0.30862909462296084
421,421,24,17,0,7,17,16.875,0.703125,-0.5704013602347544,0.51197631478779,1.942904798608943,0.9483857917921641
964,964,17,12,0,5,12,11.876470588235295,0.6986159169550173,6.363132881517957,0.6620125145593303,1.2125943849398528,0.9832414303805951
544,544,20,14,0,6,14,13.879999999999999,0.694,2.347636729199445,0.5673222713689438,0.8045620019687089,0.9137665914359505
657,657,20,14,0,6,14,13.879999999999999,0.694,4.131529266497996,0.5478290534525085,0.7918418399748696,1.0777373665074907
887,887,20,14,0,6,14,13.879999999999999,0.694,2.4851398424274045,0.5272272773643942,1.4324399209640286,1.040253650560038
934,934,20,14,0,6,14,13.879999999999999,0.694,2.9448988986676823,0.5586439265056837,0.8163651651507383,0.9619392109742337
965,965,20,14,0,6,14,13.879999999999999,0.694,3.5054549063841014,0.5520407080987497,0.9856315201751308,1.1413672039075504
308,308,13,9,0,4,9,8.884615384615387,0.683431952662722,2.3715703487763213,0.7139286256931516,0.6558417419710632,0.9615388910981064
458,458,13,9,0,4,9,8.884615384615387,0.683431952662722,2.0179639029395218,0.9017196576670917,0.22649351072319443,0.4728173392076653
695,695,13,9,0,4,9,8.884615384615387,0.683431952662722,1.6342623589046865,0.7178794526926512,0.9072027872317954,0.890917623856342
726,726,13,9,0,4,9,8.884615384615387,0.683431952662722,1.5638979091797167,0.7445297701559526,0.4322263812544334,0.7094465775821204
745,745,13,9,0,4,9,8.884615384615387,0.683431952662722,1.9316710720347472,0.7012362629555798,0.9114816049581619,1.2384909758003209
816,816,13,9,0,4,9,8.884615384615387,0.683431952662722,1.244896069434132,0.7080822855871487,0.8104999302709774,1.0647408937302167
840,840,13,9,0,4,9,8.884615384615387,0.683431952662722,3.2191745748270635,0.72206190439011,0.4833569312758898,0.7132657409812779
861,861,13,9,0,4,9,8.884615384615387,0.683431952662722,2.8336105288084097,0.6952881028100935,0.6782868952700902,0.9448715229194371
175,175,16,11,0,5,11,10.887500000000001,0.6804687500000001,0.6734093195230416,0.5844980174140673,0.6943831823170141,0.8388058513549728
326,326,16,11,0,5,11,10.887500000000001,0.6804687500000001,1.7115020207969034,0.6361111717836169,0.5096181348597587,0.7206708182216636
376,376,16,11,0,5,11,10.887500000000001,0.6804687500000001,0.5541726697590789,0.614967490845136,1.8859974028806983,1.1010036623443908
439,439,16,11,0,5,11,10.887500000000001,0.6804687500000001,1.1955882123163832,0.6046029013497688,0.46855781549632536,0.608925074694824
616,616,16,11,0,5,11,10.887500000000001,0.6804687500000001,2.687345038843431,0.6077070085048315,0.6584800976252336,0.885715771068091
659,659,16,11,0,5,11,10.887500000000001,0.6804687500000001,1.7492181195829937,0.6499233188628342,0.4552952307992276,0.692528917062703
692,692,16,11,0,5,11,10.887500000000001,0.6804687500000001,3.4629337056533505,0.6514971363273433,0.8181398827771011,1.1847759390304282
697,697,16,11,0,5,11,10.887500000000001,0.6804687500000001,1.1060731549263463,0.689974678897962,0.38537466057723907,0.5587816732334789
700,700,16,11,0,5,11,10.887500000000001,0.6804687500000001,5.516223024419358,0.6703356988458213,0.42479979986568095,0.6960771542583074
720,720,16,11,0,5,11,10.887500000000001,0.6804687500000001,2.1514111472269106,0.6340695395598497,0.9321620183249504,0.8972044283898666
783,783,16,11,0,5,11,10.887500000000001,0.6804687500000001,0.7538696072172594,0.6999030269261884,6.826046113076225,1.3586092532828096
870,870,16,11,0,5,11,10.887500000000001,0.6804687500000001,4.966567265970365,0.7372258559962924,0.548699964643839,0.9266109225306537
871,871,16,11,0,5,11,10.887500000000001,0.6804687500000001,2.661554569723386,0.6508187697100565,0.36176192267464785,0.508905699503474
915,915,16,11,0,5,11,10.887500000000001,0.6804687500000001,1.686878103806986,0.5851706133033125,0.5411129071396428,0.6802030543418475
949,949,16,11,0,5,11,10.887500000000001,0.6804687500000001,0.9410073751660138,0.6161780680813982,0.7002689626571761,0.8847821176989866
961,961,16,11,0,5,11,10.887500000000001,0.6804687500000001,5.631479077792939,0.7890286144050374,0.2987178818048142,0.6681365520847833
979,979,16,11,0,5,11,10.887500000000001,0.6804687500000001,4.474752090331361,0.6519247558626916,0.4441080565395925,0.6247230103958324
988,988,16,11,0,5,11,10.887500000000001,0.6804687500000001,5.059181969403511,0.7223981446669926,0.2975224849456213,0.5142127877110928
729,729,22,15,0,7,15,14.890909090909092,0.6768595041322315,-0.5412624554072631,0.6256757688410214,0.5667092494173588,0.7490383948462722
775,775,22,15,0,7,15,14.890909090909092,0.6768595041322315,1.4579098452430128,0.530671715948696,0.9682978642619399,1.0765336216958559
984,984,22,15,0,7,15,14.890909090909092,0.6768595041322315,3.3676981589109407,0.5370148397016455,0.4743044839888983,0.673822280061992
293,293,24,16,0,8,16,15.9,0.6625,2.669785390208176,0.4934649113860213,0.9416912814413138,1.0154767715484312
562,562,24,16,0,8,16,15.9,0.6625,-0.7177777437600017,0.46358773670361036,1.3004479922768384,0.9866483054289527
472,472,18,12,0,6,12,11.9,0.6611111111111111,0.5347519626351116,0.5517638694219998,0.8122475586322666,1.002911858809957
543,543,18,12,0,6,12,11.9,0.6611111111111111,1.6900717086920656,0.5643770643173852,0.5956354396093647,0.7919815693261318
552,552,18,12,0,6,12,11.9,0.6611111111111111,2.4896254007589427,0.6182384611628435,0.4103720341171024,0.6188239383730052
593,593,18,12,0,6,12,11.9,0.6611111111111111,1.0720158960297044,0.5602148308615567,0.8186202774518592,0.9077947277972557
630,630,18,12,0,6,12,11.9,0.6611111111111111,-0.2121771154225259,0.5678334435550076,1.463590611871173,1.2690058312268946
674,674,18,12,0,6,12,11.9,0.6611111111111111,4.1109865073939575,0.5961373323845286,0.482441611068633,0.7012835803267656
781,781,18,12,0,6,12,11.9,0.6611111111111111,-0.3412346972263939,0.5479142021937985,10.556940092619925,1.497375117540693
794,794,18,12,0,6,12,11.9,0.6611111111111111,-0.0527461835749014,0.726612360962365,0.24975308878637362,0.45382891591086094
815,815,18,12,0,6,12,11.9,0.6611111111111111,4.07498414341642,0.5731658724234865,0.4050227712446168,0.49479870068928855
873,873,18,12,0,6,12,11.9,0.6611111111111111,-0.014692168969766028,0.6051851503815736,4.097241473937871,1.1829675055613842
894,894,18,12,0,6,12,11.9,0.6611111111111111,4.903617932317592,0.5902541020287271,0.3744221318713385,0.5075378254186649
958,958,18,12,0,6,12,11.9,0.6611111111111111,2.9393760705997876,0.5623387452418505,2.0198517654338546,1.3092406288657013
550,550,20,13,0,7,13,12.91,0.6455,-0.07818312911500719,0.573719430460387,0.8055980966897627,1.118554221416622
900,900,20,13,0,7,13,12.91,0.6455,2.4087277359033035,0.5844554852490734,0.7358273387936682,0.7561455209151923
998,998,20,13,0,7,13,12.91,0.6455,5.801797300091452,0.7232119408694108,0.7107590655598034,0.9376461969241874
268,268,17,11,0,6,11,10.911764705882351,0.6418685121107266,-0.30285380445932414,0.6113781546651992,2.4544375910358416,1.177540501710764
460,460,17,11,0,6,11,10.911764705882351,0.6418685121107266,0.7075803360289096,0.5636215505241982,1.1522254455988976,0.8513877919439273
511,511,17,11,0,6,11,10.911764705882351,0.6418685121107266,2.5774964406055823,0.6499792211495101,0.4234501803472333,0.6446087637040503
586,586,17,11,0,6,11,10.911764705882351,0.6418685121107266,2.459214046896559,0.6198979205754603,0.588612867558467,0.8941149806116876
622,622,17,11,0,6,11,10.911764705882351,0.6418685121107266,1.44281630641884,0.5548271683265016,0.6023205636850797,0.7309698047661379
671,671,17,11,0,6,11,10.911764705882351,0.6418685121107266,0.3159241116691814,0.6510919162533643,1.1126547067363766,0.8010417454515882
793,793,17,11,0,6,11,10.911764705882351,0.6418685121107266,3.1658746346687368,0.7367152237684182,0.2515779398078837,0.4890928600813605
876,876,17,11,0,6,11,10.911764705882351,0.6418685121107266,-0.9004381369250607,0.6216919790399682,0.37436186840590024,0.518512404916611
208,208,14,9,0,5,9,8.914285714285716,0.6367346938775512,1.6159970966248918,0.6628653429755588,1.635696185171723,1.3647649164581703
231,231,14,9,0,5,9,8.914285714285716,0.6367346938775512,0.5617028717383931,0.6502188950735117,0.5526750298150599,0.7344633665850371
358,358,14,9,0,5,9,8.914285714285716,0.6367346938775512,0.7659215523637792,0.6716830344405602,0.7111706077477334,0.9218382767868716
377,377,14,9,0,5,9,8.914285714285716,0.6367346938775512,0.6226887875742678,0.7335770236465673,0.33699638777468705,0.5145187271921056
400,400,14,9,0,5,9,8.914285714285716,0.6367346938775512,-0.7867788744676769,0.7160360065282968,0.6471063893851949,0.8325450994129758
418,418,14,9,0,5,9,8.914285714285716,0.6367346938775512,3.367641316007398,0.7308554871760514,0.3962422552875403,0.696285307496612
429,429,14,9,0,5,9,8.914285714285716,0.6367346938775512,3.3349536094746877,0.7328541561349209,0.7887097264652415,1.2209835964216664
435,435,14,9,0,5,9,8.914285714285716,0.6367346938775512,1.5628355526904922,0.699906526971354,0.5810826280276282,0.8495502053034387
452,452,14,9,0,5,9,8.914285714285716,0.6367346938775512,-0.3864646094520934,0.6790119368834585,0.8457198340831589,0.9578627647383166
476,476,14,9,0,5,9,8.914285714285716,0.6367346938775512,1.8457844415527422,0.6557053132046,2.1210934675763218,1.3270525754844762
498,498,14,9,0,5,9,8.914285714285716,0.6367346938775512,-0.010174744494661053,0.661695289241436,0.7091474458328454,0.9842529868603925
508,508,14,9,0,5,9,8.914285714285716,0.6367346938775512,1.6301384241241006,0.6686818512234319,2.0732332818168784,1.4804857467681316
513,513,14,9,0,5,9,8.914285714285716,0.6367346938775512,2.227975045204629,0.6410449191021542,0.7630950581709458,0.9396795631828271
522,522,14,9,0,5,9,8.914285714285716,0.6367346938775512,1.1808286733020898,0.6368153409329103,1.033259167279855,0.9776998244825084
547,547,14,9,0,5,9,8.914285714285716,0.6367346938775512,2.665252467666983,0.6748615369849892,0.5696031345414211,0.777710626436298
582,582,14,9,0,5,9,8.914285714285716,0.6367346938775512,1.9622010947599056,0.6317963186901564,0.8707590051047621,1.0175423365524192
584,584,14,9,0,5,9,8.914285714285716,0.6367346938775512,2.4331545046683187,0.8393604681151388,0.2442527380685024,0.4999226581766813
639,639,14,9,0,5,9,8.914285714285716,0.6367346938775512,4.358501559227501,0.7676738451172661,0.2292371361173726,0.3667677964466012
651,651,14,9,0,5,9,8.914285714285716,0.6367346938775512,0.4356809967648494,0.625925636929346,0.5250711459558005,0.6536577414066789
669,669,14,9,0,5,9,8.914285714285716,0.6367346938775512,2.0827541430218672,0.7230185492724619,0.4280441505432878,0.6408503126394651
676,676,14,9,0,5,9,8.914285714285716,0.6367346938775512,0.6347464795905672,0.6084266944019037,0.6365363951693759,0.7675116866793198
687,687,14,9,0,5,9,8.914285714285716,0.6367346938775512,1.0053107199099254,0.663602394520043,1.01082440439961,0.9981465771534912
706,706,14,9,0,5,9,8.914285714285716,0.6367346938775512,3.1838634753580233,0.6778320151009871,0.8574393981787422,1.0583679826699999
751,751,14,9,0,5,9,8.914285714285716,0.6367346938775512,1.8973830272775425,0.7154639943696997,0.26931487341829546,0.3673869759506235
763,763,14,9,0,5,9,8.914285714285716,0.6367346938775512,3.6993797700608018,0.7557191730599406,0.43860365931098766,0.8165025669279511
788,788,14,9,0,5,9,8.914285714285716,0.6367346938775512,0.5368516591232013,0.6752774562625767,0.5109876074422466,0.6871420216521581
792,792,14,9,0,5,9,8.914285714285716,0.6367346938775512,1.6309748203252765,0.689039353196755,0.6203038475607097,0.8605997518659567
799,799,14,9,0,5,9,8.914285714285716,0.6367346938775512,1.4556148287364312,0.644866977004462,0.5145957539584421,0.6693205850829167
810,810,14,9,0,5,9,8.914285714285716,0.6367346938775512,1.046196131065999,0.6169801444931773,9.50606795422831,0.9444820259005274
829,829,14,9,0,5,9,8.914285714285716,0.6367346938775512,1.9641827544320505,0.6789739422178911,0.521307068643765,0.779559121893528
830,830,14,9,0,5,9,8.914285714285716,0.6367346938775512,1.4376668621648157,0.6901393280893389,1.4812477247548812,1.4460799766834724
850,850,14,9,0,5,9,8.914285714285716,0.6367346938775512,5.158700251117745,0.7477342695175797,0.2815800149170119,0.45904093985823996
858,858,14,9,0,5,9,8.914285714285716,0.6367346938775512,0.1307217299533224,0.6388666444892557,1.2726642797055718,1.3929100090163742
862,862,14,9,0,5,9,8.914285714285716,0.6367346938775512,4.405371827047815,0.8246037064630422,0.31784314500567284,0.687398845252682
863,863,14,9,0,5,9,8.914285714285716,0.6367346938775512,2.263026594906381,0.7189090461503729,0.4852051193790876,0.838267218303303
917,917,14,9,0,5,9,8.914285714285716,0.6367346938775512,1.747014290132365,0.8031803777330208,0.5836999694442753,0.9485307609548794
924,924,14,9,0,5,9,8.914285714285716,0.6367346938775512,2.4946456243235042,0.6754999581824553,1.052877371061643,1.3709721740143948
954,954,14,9,0,5,9,8.914285714285716,0.6367346938775512,0.717127923033718,0.6264340361277622,1.0753930401583889,1.0502830281614697
975,975,14,9,0,5,9,8.914285714285716,0.6367346938775512,6.1911586569515755,0.863217678277238,0.1594578555928598,0.2803138864657746
990,990,14,9,0,5,9,8.914285714285716,0.6367346938775512,2.1219387443707696,0.6329036859137506,0.7110650574929146,0.9365459512128876
412,412,22,14,0,8,14,13.918181818181818,0.6326446280991735,2.4272444278524157,0.535140627322257,0.5844797037859323,0.8756723710699437
841,841,22,14,0,8,14,13.918181818181818,0.6326446280991735,1.2046714827904086,0.5301564167391033,1.609147129061627,1.2644776098148642
374,374,19,12,0,7,12,11.921052631578947,0.6274238227146814,-0.21252856345318816,0.5220903372405068,0.7499206398386212,0.8425878529711436
960,960,24,15,0,9,15,14.925,0.6218750000000001,0.828903810125211,0.5123544961398793,0.8625990106629132,0.941919385714535
394,394,16,10,0,6,10,9.925,0.6203125,0.25410232308635644,0.6174271726767449,0.4962992540232991,0.6721464464495968
459,459,16,10,0,6,10,9.925,0.6203125,0.08324311644643399,0.631625162233127,0.8015503027916795,0.9089999209849633
463,463,16,10,0,6,10,9.925,0.6203125,1.00638602099788,0.5985706525852612,0.7977392537532231,0.9622860993528162
485,485,16,10,0,6,10,9.925,0.6203125,1.4494205271617904,0.668711941112562,0.3716848579751642,0.5843313742552061
493,493,16,10,0,6,10,9.925,0.6203125,1.140724427960913,0.6380724183624126,0.8674037702137234,0.9724614603051779
635,635,16,10,0,6,10,9.925,0.6203125,1.9912092850802012,0.62271492481042,1.7132237747461474,1.232014611189819
736,736,16,10,0,6,10,9.925,0.6203125,1.1081219390404629,0.6570557450071569,7.624068292900376,1.3463724663481333
752,752,16,10,0,6,10,9.925,0.6203125,4.382266187762131,0.6801955309559431,0.5279021996529539,0.7821270095974285
809,809,16,10,0,6,10,9.925,0.6203125,0.11484162895413344,0.5586286100768633,0.6803291542460217,0.7673487796025859
811,811,16,10,0,6,10,9.925,0.6203125,3.2889685445159573,0.5836845534254312,1.0076945055156488,1.1693834770897513
814,814,16,10,0,6,10,9.925,0.6203125,2.4176351020582896,0.6306625846466464,0.5188527939024801,0.743261869182399
833,833,16,10,0,6,10,9.925,0.6203125,-0.12721956759822425,0.589398932897302,0.7716215655450036,0.8972020750604939
839,839,16,10,0,6,10,9.925,0.6203125,3.5603707730697387,0.622200095553637,0.6194929470203832,0.8796556322788822
847,847,16,10,0,6,10,9.925,0.6203125,1.0850682631824784,0.568762123060789,0.6703737303868309,0.8203362584057241
857,857,16,10,0,6,10,9.925,0.6203125,4.055008550874425,0.6742322918144458,0.4068199110419372,0.6734125037505245
859,859,16,10,0,6,10,9.925,0.6203125,3.4461730541994267,0.6561387442359793,0.2881814370896543,0.395469853056938
902,902,16,10,0,6,10,9.925,0.6203125,2.2492227445370427,0.605878350913588,0.5082683360706352,0.6806990078235412
908,908,16,10,0,6,10,9.925,0.6203125,1.957718712717401,0.6075315602817852,0.9617806002171067,1.0480057038616704
943,943,16,10,0,6,10,9.925,0.6203125,3.391394717420918,0.5810179791956037,4.781717211942643,1.2715940916975335
992,992,16,10,0,6,10,9.925,0.6203125,0.8678246916507143,0.6090498526681125,0.9291029898470815,1.0607579390994124
132,132,13,8,0,5,8,7.930769230769231,0.6100591715976331,0.11247714096950377,0.6859758115452258,0.5628170020548635,0.7024133063237603
256,256,13,8,0,5,8,7.930769230769231,0.6100591715976331,1.4146174086282581,0.634679991966962,0.7219902840760196,0.8234478357459746
325,325,13,8,0,5,8,7.930769230769231,0.6100591715976331,1.659783115482192,0.6968776489968638,1.8157181951333525,1.1950495578010816
467,467,13,8,0,5,8,7.930769230769231,0.6100591715976331,1.0965916126535737,0.6816371935477326,2.32533608549776,1.3430510808223586
484,484,13,8,0,5,8,7.930769230769231,0.6100591715976331,0.07202618511278212,0.807928529167419,0.32775479518067085,0.5565271091648065
675,675,13,8,0,5,8,7.930769230769231,0.6100591715976331,4.498808314135678,0.957090931248337,0.16701577351089886,0.3906480234801844
685,685,13,8,0,5,8,7.930769230769231,0.6100591715976331,1.6928271697001738,0.8234759205310487,0.21714450414237413,0.3721865888929499
707,707,13,8,0,5,8,7.930769230769231,0.6100591715976331,2.218349562377962,0.6887907545789191,0.7762306135844663,0.7949579402274213
725,725,13,8,0,5,8,7.930769230769231,0.6100591715976331,1.8893162865171862,0.7125288099729977,2.547551029593429,1.2451602580942993
759,759,13,8,0,5,8,7.930769230769231,0.6100591715976331,1.6078349490935782,0.6882108414642246,1.5499491443966502,1.6672081396793594
767,767,13,8,0,5,8,7.930769230769231,0.6100591715976331,0.6938612151313338,0.6988438355040566,0.46225172729140784,0.5787976775802198
806,806,13,8,0,5,8,7.930769230769231,0.6100591715976331,2.8712542085003743,0.6993626131621428,0.4053654213703312,0.5782921762749325
849,849,13,8,0,5,8,7.930769230769231,0.6100591715976331,2.162144379138477,0.6798146398984686,2.829357817996247,1.183877033338139
852,852,13,8,0,5,8,7.930769230769231,0.6100591715976331,1.155804092475767,0.627620981862303,0.707618022616469,0.8186895685985667
868,868,13,8,0,5,8,7.930769230769231,0.6100591715976331,2.074088699364957,0.7720799764607706,0.5229939383475753,0.9013835509765545
872,872,13,8,0,5,8,7.930769230769231,0.6100591715976331,1.2293255651382053,0.6450207447770053,0.9320677828660856,0.9347676785085048
879,879,13,8,0,5,8,7.930769230769231,0.6100591715976331,-0.570159387580547,0.7842231814860539,0.3554395600731762,0.5837406948214166
933,933,13,8,0,5,8,7.930769230769231,0.6100591715976331,1.038659173275298,0.6735927844196226,0.6175959035817206,0.7884770569751289
978,978,13,8,0,5,8,7.930769230769231,0.6100591715976331,1.3557066301278073,0.7481353812476275,0.4643336839991567,0.7440120552851507
292,292,18,11,0,7,11,10.933333333333334,0.6074074074074074,1.1474794859801363,0.5903822714097758,1.5999740460043124,0.8151503144425657
369,369,18,11,0,7,11,10.933333333333334,0.6074074074074074,1.861503488120964,0.5449404720871057,1.4975511131149954,1.051225404184903
568,568,18,11,0,7,11,10.933333333333334,0.6074074074074074,1.9385198953294154,0.5682646232698619,0.6717176464649134,0.9067720845217141
634,634,18,11,0,7,11,10.933333333333334,0.6074074074074074,-0.07566834611235738,0.6259219247248677,0.32351871995837345,0.4593405265106764
691,691,18,11,0,7,11,10.933333333333334,0.6074074074074074,2.3490565642339605,0.6518504478932686,0.7252241081861139,1.0927442693152842
743,743,18,11,0,7,11,10.933333333333334,0.6074074074074074,1.4688290587674564,0.5212351162859827,0.951727940812306,0.9782806719384938
828,828,18,11,0,7,11,10.933333333333334,0.6074074074074074,1.1841075841687918,0.5967444778879635,0.9686899845936318,1.1950135310828116
932,932,18,11,0,7,11,10.933333333333334,0.6074074074074074,3.6963610834274947,0.618522889369916,0.9129707689018614,1.2810918626924162
983,983,18,11,0,7,11,10.933333333333334,0.6074074074074074,0.9617720531870235,0.626430392627191,3.8367442864785213,0.9811213034390115
999,999,18,11,0,7,11,10.933333333333334,0.6074074074074074,3.9332457109011796,0.6183340988519875,0.7154685467638475,1.0512848610859176
555,555,23,14,0,9,14,13.93478260869565,0.60586011342155,0.7966378745808884,0.547558305776206,0.6649715379966167,0.9718661395961286
11,11,20,12,0,8,12,11.94,0.597,2.700945442458534,0.5630205036488102,0.572659893532459,0.7516742259267715
383,383,20,12,0,8,12,11.94,0.597,-1.7180593752580893,0.6208990968704627,0.3872329247533587,0.6401587062921207
898,898,20,12,0,8,12,11.94,0.597,2.5667462588768495,0.5429717682668035,0.5870434512883203,0.7549902909002337
940,940,20,12,0,8,12,11.94,0.597,-0.19795516554421125,0.5291527020267283,0.5283570078748162,0.6371100456179167
948,948,20,12,0,8,12,11.94,0.597,3.161162879702169,0.6055323730818551,0.784018663515865,1.0038620705811723
443,443,22,13,0,9,13,12.945454545454545,0.5884297520661157,0.33561156381593604,0.5343082811009429,0.4830745397124084,0.6831199636854484
128,128,17,10,0,7,10,9.947058823529412,0.585121107266436,-1.1721409983705073,0.6550963028383949,0.3323952448114774,0.5288390765769211
301,301,17,10,0,7,10,9.947058823529412,0.585121107266436,2.182402014766743,0.5587700613650303,1.2539833369741393,1.1575892644991026
481,481,17,10,0,7,10,9.947058823529412,0.585121107266436,0.7368213350813407,0.5821601839870515,0.5704871267022124,0.7626197001878123
491,491,17,10,0,7,10,9.947058823529412,0.585121107266436,1.8605228720642006,0.5145958446147043,1.2199107982567508,1.1122787664435207
587,587,17,10,0,7,10,9.947058823529412,0.585121107266436,3.013397613154578,0.6535380259420118,0.42716087349370824,0.7123255305119295
595,595,17,10,0,7,10,9.947058823529412,0.585121107266436,-0.3871186738943376,0.5857808835859767,1.453950768574319,1.1778552745159385
680,680,17,10,0,7,10,9.947058823529412,0.585121107266436,1.9940780901553512,0.5430116797287429,1.1492541925332749,1.126177379429715
766,766,17,10,0,7,10,9.947058823529412,0.585121107266436,1.7646669639380534,0.5589500438960168,0.7765551687917309,0.948300306191949
388,388,24,14,0,10,14,13.95,0.5812499999999999,-0.7214534846533963,0.5206158012332611,0.47602697935433175,0.672288352090517
941,941,24,14,0,10,14,13.95,0.5812499999999999,1.3563865032548348,0.5059619876382935,0.5024575791463565,0.6643617716052338
359,359,19,11,0,8,11,10.952631578947368,0.5764542936288088,-0.45839195706024677,0.5952329533884348,2.9318767133672416,1.7091925481190429
100,100,35,20,0,15,20,19.95714285714286,0.5702040816326531,1.2916879726237411,0.6040928045675061,42.382649519080864,4.104900341744828
1,1,14,8,0,6,8,7.957142857142857,0.5683673469387756,3.584990120371244,0.8886404822443006,0.25050876255018345,0.6099969159653614
61,61,14,8,0,6,8,7.957142857142857,0.5683673469387756,0.6878311729166838,0.6854004757873728,1.2275591386738358,1.1982899372471034
105,105,14,8,0,6,8,7.957142857142857,0.5683673469387756,0.29575233787715555,0.5904034762613148,0.6998365913507654,0.7931819980250433
116,116,14,8,0,6,8,7.957142857142857,0.5683673469387756,1.5200191778892054,0.5943675528352966,1.088058235111985,0.9820094717944179
162,162,14,8,0,6,8,7.957142857142857,0.5683673469387756,-0.6319384835689974,0.6788276927643145,8.341956976391335,1.490565885788905
198,198,14,8,0,6,8,7.957142857142857,0.5683673469387756,0.2325311408295032,0.7334441444296637,0.48612257022690536,0.7494968025745926
202,202,14,8,0,6,8,7.957142857142857,0.5683673469387756,-0.07209289948882214,0.7224148998515185,0.34878028064467376,0.5409155087242336
209,209,14,8,0,6,8,7.957142857142857,0.5683673469387756,0.6218673126014549,0.6362848005732178,1.0552165211868219,1.0244345082346862
259,259,14,8,0,6,8,7.957142857142857,0.5683673469387756,-0.08149269591606965,0.6403358168619803,0.7985958675704564,0.9343417555741338
269,269,14,8,0,6,8,7.957142857142857,0.5683673469387756,-0.4914529531540015,0.6749170875935042,0.46707520314329987,0.6563249310099549
287,287,14,8,0,6,8,7.957142857142857,0.5683673469387756,1.1340201682309319,0.6675399522561737,0.4856805780177108,0.6776149158577375
291,291,14,8,0,6,8,7.957142857142857,0.5683673469387756,0.20908302924201858,0.6533330687786177,1.237102718620606,1.3705841127905265
295,295,14,8,0,6,8,7.957142857142857,0.5683673469387756,0.22764449368727516,0.6964225334492536,1.5020094310829186,1.0303837856723201
344,344,14,8,0,6,8,7.957142857142857,0.5683673469387756,3.742728522630452,0.7574665295318187,0.6050786511412374,1.0057991017684271
363,363,14,8,0,6,8,7.957142857142857,0.5683673469387756,-2.369531523809155,0.6868546996271977,0.4410128927116292,0.6596218014779701
365,365,14,8,0,6,8,7.957142857142857,0.5683673469387756,2.7878811723334453,0.7871932172938904,0.21180990496589405,0.3328109443125264
375,375,14,8,0,6,8,7.957142857142857,0.5683673469387756,-0.6138095840229151,0.7341269731418627,0.33475332556718956,0.5289713546114899
379,379,14,8,0,6,8,7.957142857142857,0.5683673469387756,3.093292774874378,0.6413216728918014,0.5129581699848427,0.6737452127996577
390,390,14,8,0,6,8,7.957142857142857,0.5683673469387756,-0.43900014799974096,0.6331161529577494,0.8479552148507646,0.8641252146481427
391,391,14,8,0,6,8,7.957142857142857,0.5683673469387756,1.0949929407473316,0.6321988833946989,0.7437199216042688,0.8756640161885132
428,428,14,8,0,6,8,7.957142857142857,0.5683673469387756,1.9835783229543453,0.6578679694223706,0.7626570450038178,0.9984695651882893
453,453,14,8,0,6,8,7.957142857142857,0.5683673469387756,1.3416418360773323,0.626125512207448,0.7544969285585912,0.8411223698709428
456,456,14,8,0,6,8,7.957142857142857,0.5683673469387756,2.6718446293208555,0.6550612400653644,0.4970658098659463,0.6466058678648825
471,471,14,8,0,6,8,7.957142857142857,0.5683673469387756,0.8048501589448167,0.6989872464413954,0.4947245017484912,0.7429808402710409
502,502,14,8,0,6,8,7.957142857142857,0.5683673469387756,0.5858974672514696,0.6193404566728435,1.3405290457262962,0.8674527450901697
505,505,14,8,0,6,8,7.957142857142857,0.5683673469387756,0.05601775788005178,0.6791450118592846,0.4201106946631063,0.6181900775122013
523,523,14,8,0,6,8,7.957142857142857,0.5683673469387756,0.6467550670393788,0.5918948821864,1.180747097649964,1.1107574545777523
532,532,14,8,0,6,8,7.957142857142857,0.5683673469387756,2.9294129791124393,0.6559339847082017,1.0887705887960875,1.013378087575876
540,540,14,8,0,6,8,7.957142857142857,0.5683673469387756,0.6719355059438807,0.6350347123916193,0.4377359704589792,0.5057607098631772
559,559,14,8,0,6,8,7.957142857142857,0.5683673469387756,0.6423391274244354,0.59239001584327,0.5964395688800365,0.6789735054428848
565,565,14,8,0,6,8,7.957142857142857,0.5683673469387756,-0.48249781099317607,0.6992251589491479,1.4895376140398429,1.6287286530443321
575,575,14,8,0,6,8,7.957142857142857,0.5683673469387756,-0.3262175922490527,0.6793295374874859,1.523725218932778,1.060462212222198
583,583,14,8,0,6,8,7.957142857142857,0.5683673469387756,1.705101085312385,0.6377759854870891,0.7165738129304753,0.9018017027956761
600,600,14,8,0,6,8,7.957142857142857,0.5683673469387756,0.26204970775501457,0.6446870496373931,0.6096946250716323,0.8095791854121989
628,628,14,8,0,6,8,7.957142857142857,0.5683673469387756,0.6350413221449039,0.6482865470345305,0.49185061723327966,0.6290716410489924
629,629,14,8,0,6,8,7.957142857142857,0.5683673469387756,3.3468990914236993,0.6943444148788639,0.5560098340738826,0.8637110032885053
647,647,14,8,0,6,8,7.957142857142857,0.5683673469387756,-0.39304165442624167,0.6323068814320763,1.2940032952537024,1.1282854951342378
652,652,14,8,0,6,8,7.957142857142857,0.5683673469387756,-0.5770516143862549,0.7925939846337107,0.8514123446625509,1.1086463495204593
662,662,14,8,0,6,8,7.957142857142857,0.5683673469387756,2.8353989196177602,0.6267116348164458,0.6994899812881439,0.8784365793511688
670,670,14,8,0,6,8,7.957142857142857,0.5683673469387756,-1.3499326804385663,0.7103002398719691,1.0443719676726808,1.1239635530726069
701,701,14,8,0,6,8,7.957142857142857,0.5683673469387756,0.7844777328644233,0.6600020011988751,1.1235883726955531,1.053474160270115
717,717,14,8,0,6,8,7.957142857142857,0.5683673469387756,0.9289722182171318,0.6405006396794073,1.1964104666167388,0.8897761604804018
721,721,14,8,0,6,8,7.957142857142857,0.5683673469387756,2.6085374149737137,0.6739010866449471,0.6738192037914862,0.9382741473611681
724,724,14,8,0,6,8,7.957142857142857,0.5683673469387756,4.3792230001178405,0.7198735487520095,0.4804027624566922,0.7676968057915028
790,790,14,8,0,6,8,7.957142857142857,0.5683673469387756,0.9111789793163041,0.6202182551291521,4.716280827494527,1.1171988882934336
791,791,14,8,0,6,8,7.957142857142857,0.5683673469387756,0.4895917493177547,0.6525151628476489,1.3978545127251678,1.304154392958073
795,795,14,8,0,6,8,7.957142857142857,0.5683673469387756,-0.4577990418690108,0.6454506191434092,0.71674461781438,0.9423483304452968
800,800,14,8,0,6,8,7.957142857142857,0.5683673469387756,3.3702105676955116,0.6341248319948032,0.5162463978312781,0.66077793662058
801,801,14,8,0,6,8,7.957142857142857,0.5683673469387756,3.626763211951617,0.6937835368427369,0.6764617651073083,0.932192220798957
804,804,14,8,0,6,8,7.957142857142857,0.5683673469387756,0.8257345329623988,0.6250488666707534,0.47332062535056274,0.5815302343194623
805,805,14,8,0,6,8,7.957142857142857,0.5683673469387756,1.5724249515787108,0.674393008450983,0.430130557854483,0.6176734846177222
821,821,14,8,0,6,8,7.957142857142857,0.5683673469387756,-0.32213565994536175,0.6434439368658313,0.6906199050392143,0.9509889585566155
832,832,14,8,0,6,8,7.957142857142857,0.5683673469387756,4.565985182329805,0.8213760354101075,0.3164308805478044,0.6519519867958179
834,834,14,8,0,6,8,7.957142857142857,0.5683673469387756,1.4478973270938262,0.6982780991995,0.3177511765495701,0.4423934586295385
851,851,14,8,0,6,8,7.957142857142857,0.5683673469387756,1.8240322885162492,0.8294985431935369,0.2819971811041921,0.5466053376731599
853,853,14,8,0,6,8,7.957142857142857,0.5683673469387756,-0.45987653032369125,0.635111963783899,0.48925666702761106,0.6082341546809552
864,864,14,8,0,6,8,7.957142857142857,0.5683673469387756,1.0564708946771546,0.7029529630965687,0.5032378138485251,0.7572079812014867
878,878,14,8,0,6,8,7.957142857142857,0.5683673469387756,0.751682865022116,0.6537417239922307,0.9245637473104134,1.2261718792756169
963,963,14,8,0,6,8,7.957142857142857,0.5683673469387756,2.57475716931391,0.6375909571229512,0.6423010992688515,0.707709833692973
987,987,14,8,0,6,8,7.957142857142857,0.5683673469387756,2.172282033999644,0.6326233853705482,0.974683390951614,1.1095945246713166
648,648,23,13,0,10,13,12.960869565217392,0.5635160680529301,-1.1824676472388576,0.4778621072934185,0.5614399978413936,0.6737130710669689
139,139,16,9,0,7,9,8.9625,0.56015625,0.27738710724374566,0.5710554615386398,0.648799825993456,0.8127215482503187
290,290,16,9,0,7,9,8.9625,0.56015625,1.926589527759225,0.6459460134639112,0.5059733570111584,0.7411839619361034
398,398,16,9,0,7,9,8.9625,0.56015625,5.5277717732062825,0.9145487835342129,0.16326965376701352,0.4284483877423535
509,509,16,9,0,7,9,8.9625,0.56015625,0.9606857610781684,0.5877344763092573,0.5578803192945083,0.6931447032203778
517,517,16,9,0,7,9,8.9625,0.56015625,0.6607952584468043,0.6470259937147746,0.5178796837679238,0.7447611003309208
537,537,16,9,0,7,9,8.9625,0.56015625,1.9788365447102132,0.5962219749066475,0.6136582498538145,0.7875342948234565
553,553,16,9,0,7,9,8.9625,0.56015625,1.2819441370648834,0.564122807688161,0.7790641665887872,0.9136588182046528
614,614,16,9,0,7,9,8.9625,0.56015625,-0.05778507364865654,0.7011978459460751,0.4172170776920912,0.6836849551054494
631,631,16,9,0,7,9,8.9625,0.56015625,0.10197597887395181,0.6473098482888691,0.3964362097171048,0.5663068339540691
665,665,16,9,0,7,9,8.9625,0.56015625,2.309106119926363,0.626358679658487,2.523489058533321,1.3024518727352878
677,677,16,9,0,7,9,8.9625,0.56015625,0.058815640947580614,0.6018896023402921,0.5057353066398285,0.6757803785272247
693,693,16,9,0,7,9,8.9625,0.56015625,0.6130486917790137,0.5528151003919447,0.65876848876236,0.7637707130002893
770,770,16,9,0,7,9,8.9625,0.56015625,0.8560212590090389,0.6062084573824135,1.9199029706193018,1.592835942385226
889,889,16,9,0,7,9,8.9625,0.56015625,4.715724453006267,0.7221411671266589,0.3803216807031822,0.7098086541911938
893,893,16,9,0,7,9,8.9625,0.56015625,1.154242042423657,0.6480729469190294,17.326150852756108,1.5022729297860795
912,912,16,9,0,7,9,8.9625,0.56015625,3.7811470927390607,0.7447001265809587,0.41856989544392253,0.7317596444356221
920,920,16,9,0,7,9,8.9625,0.56015625,3.174949795636088,0.6478439554326701,0.587211156175067,0.7954271911845214
45,45,18,10,0,8,10,9.966666666666667,0.5537037037037037,0.43721978721763305,0.5720468347444028,0.6724828561655349,0.7710890018094898
234,234,18,10,0,8,10,9.966666666666667,0.5537037037037037,0.13311546417262302,0.6030477625814148,0.7204804542420552,0.8363562742321586
330,330,18,10,0,8,10,9.966666666666667,0.5537037037037037,-0.6818713528172688,0.5675552971168843,0.5445554813749559,0.7335665220846217
343,343,18,10,0,8,10,9.966666666666667,0.5537037037037037,-0.4933024248339874,0.5530742099795372,0.6733525122560343,0.838023607728532
353,353,18,10,0,8,10,9.966666666666667,0.5537037037037037,-3.2542990410793213,0.6096040965862025,0.40957849933495916,0.5991235374991617
397,397,18,10,0,8,10,9.966666666666667,0.5537037037037037,1.5404262020404411,0.5347777808849522,0.997313957969992,1.0907011565039244
436,436,18,10,0,8,10,9.966666666666667,0.5537037037037037,-0.20254159493735183,0.5593850829057598,0.7692978657128929,0.9189403230393844
445,445,18,10,0,8,10,9.966666666666667,0.5537037037037037,0.24585286631556685,0.5522647941191025,0.7042872635756601,0.9202829196529004
466,466,18,10,0,8,10,9.966666666666667,0.5537037037037037,-0.15564481889159593,0.5303097729519526,0.6526207962814057,0.7353214328451698
556,556,18,10,0,8,10,9.966666666666667,0.5537037037037037,2.348331811658948,0.586765904844564,0.5595290218983854,0.7994848918702943
577,577,18,10,0,8,10,9.966666666666667,0.5537037037037037,0.5696838134822446,0.5567537756365063,0.5466977125337938,0.6749971343851402
604,604,18,10,0,8,10,9.966666666666667,0.5537037037037037,-0.46013216035861076,0.5774266303617137,1.1907482077383837,1.1797248316059885
618,618,18,10,0,8,10,9.966666666666667,0.5537037037037037,0.07308033646341956,0.547704031472581,0.7146832500951391,0.78784312563047
626,626,18,10,0,8,10,9.966666666666667,0.5537037037037037,1.9352060124250472,0.5409232270335941,3.788069360902002,0.9831754751346752
664,664,18,10,0,8,10,9.966666666666667,0.5537037037037037,0.9049343270180148,0.5925397914268379,0.49721863790412,0.7197904778625112
699,699,18,10,0,8,10,9.966666666666667,0.5537037037037037,2.302422579595499,0.5499966908503054,1.001799180539437,1.1358211515554264
746,746,18,10,0,8,10,9.966666666666667,0.5537037037037037,0.10305278571229236,0.5469291349197124,0.6463001116446585,0.7427296652522749
758,758,18,10,0,8,10,9.966666666666667,0.5537037037037037,0.8949363678725416,0.5504370974148118,0.43189155330216117,0.5074600374525376
843,843,18,10,0,8,10,9.966666666666667,0.5537037037037037,1.7579169832990813,0.5765169868689747,0.8046265403230761,0.8240020357161755
903,903,18,10,0,8,10,9.966666666666667,0.5537037037037037,-0.2311735397154373,0.5850855640803766,0.4533953805812363,0.641828653042463
916,916,18,10,0,8,10,9.966666666666667,0.5537037037037037,3.5399933063606372,0.6815551114561599,0.9887739936609005,1.2831168832468312
946,946,18,10,0,8,10,9.966666666666667,0.5537037037037037,2.7674936566393766,0.568292206404103,0.9464883671437209,1.1436895974688543
305,305,20,11,0,9,11,10.969999999999999,0.5485,0.5085268119871971,0.5362653658646571,0.924089528635055,1.0489868541384302
331,331,20,11,0,9,11,10.969999999999999,0.5485,1.8429708481586113,0.5076805514633692,0.8222118546285543,0.8809969727057747
395,395,20,11,0,9,11,10.969999999999999,0.5485,2.432894780404947,0.5264306485440083,1.8450980734699272,1.1608171683368704
702,702,20,11,0,9,11,10.969999999999999,0.5485,2.013062239402384,0.48901370659349724,0.9966011435178543,1.059134094483797
757,757,20,11,0,9,11,10.969999999999999,0.5485,0.8167003750767301,0.5227106528254601,0.6947843202207707,0.8453597536456323
796,796,20,11,0,9,11,10.969999999999999,0.5485,0.5147513632879076,0.5101681170635429,2.211242457398275,0.9731693666430047
905,905,20,11,0,9,11,10.969999999999999,0.5485,3.592493906127276,0.6010779443513893,0.5429386101595505,0.9001122793668112
939,939,20,11,0,9,11,10.969999999999999,0.5485,2.3032652363806414,0.5444833250820492,0.6650629769386578,0.8341465714490037
8,8,22,12,0,10,12,11.972727272727271,0.5442148760330577,0.6729427685500938,0.48327860784861104,0.6794210825756761,0.8172812231196264
96,96,22,12,0,10,12,11.972727272727271,0.5442148760330577,-2.2240983374124172,0.528558608084969,0.4584678702797431,0.6297007059513055
646,646,22,12,0,10,12,11.972727272727271,0.5442148760330577,0.9390225126624181,0.4657546839107595,2.005893659753298,1.331688147860903
880,880,22,12,0,10,12,11.972727272727271,0.5442148760330577,-0.9751280300693391,0.5203765092862829,0.9300240257810156,0.9903190698130696
886,886,22,12,0,10,12,11.972727272727271,0.5442148760330577,1.11799877565055,0.48055162620043423,0.7296098934160434,0.8325581457390784
9,9,24,13,0,11,13,12.975,0.540625,2.957770189378093,0.4602612944361398,0.8179971213167626,0.9457240233552783
114,114,13,7,0,6,7,6.976923076923076,0.5366863905325443,0.4616925827098011,0.620194485510014,0.7095322007453728,0.805028839069964
350,350,13,7,0,6,7,6.976923076923076,0.5366863905325443,-0.010623064819986452,0.7108223975399159,0.7454234839256766,0.980983527175216
352,352,13,7,0,6,7,6.976923076923076,0.5366863905325443,0.8936652504595939,0.6700451779792703,0.9382671088139751,0.9858172629799399
504,504,13,7,0,6,7,6.976923076923076,0.5366863905325443,0.6176202107280855,0.7229106024880918,0.6990403284677829,0.9128445333001909
539,539,13,7,0,6,7,6.976923076923076,0.5366863905325443,-0.28993100083618256,0.6724279392547842,0.46132065285099677,0.6064599821955781
567,567,13,7,0,6,7,6.976923076923076,0.5366863905325443,-0.16589094874346835,0.6584707249542937,0.44936491903625514,0.5617154559713488
580,580,13,7,0,6,7,6.976923076923076,0.5366863905325443,0.427166580060202,0.75544924584692,2.4952938815850394,1.2444965003497181
637,637,13,7,0,6,7,6.976923076923076,0.5366863905325443,0.5358721638249292,0.6104706261387283,0.6120783481622833,0.6710490790980487
772,772,13,7,0,6,7,6.976923076923076,0.5366863905325443,0.5699745242478026,0.6350505948728726,1.210487889462204,1.241485816935679
784,784,13,7,0,6,7,6.976923076923076,0.5366863905325443,-0.5766129865464233,0.7852941151570344,1.2986063357535722,1.4982424748610754
786,786,13,7,0,6,7,6.976923076923076,0.5366863905325443,1.5822347624881616,0.6765339548896314,0.4348391310166174,0.5793604616757312
848,848,13,7,0,6,7,6.976923076923076,0.5366863905325443,2.1332725861830104,0.7110334425917492,0.658368164631315,0.7924747493733901
919,919,13,7,0,6,7,6.976923076923076,0.5366863905325443,1.6850463379716467,0.7545608281957554,0.4264933744097471,0.7097318137681122
947,947,13,7,0,6,7,6.976923076923076,0.5366863905325443,0.01652435362939339,0.6931332986505998,3.2534496400445287,1.826673993791783
419,419,17,9,0,8,9,8.98235294117647,0.5283737024221453,1.952354348890904,0.6018651554593288,0.5438780226983546,0.7726814290409165
681,681,17,9,0,8,9,8.98235294117647,0.5283737024221453,-0.16623615458549462,0.6031155371701714,0.7556365080322716,0.9401656305067843
185,185,19,10,0,9,10,9.98421052631579,0.5254847645429364,-0.269560014769103,0.5279491195036263,0.9720427282653967,1.048124280836501
4,4,14,7,0,7,7,7,0.5,0.8422060605026902,0.6341700118848114,0.8653873231844964,0.9585447137386467
6,6,14,7,0,7,7,7,0.5,0.6131668755464179,0.6790158718530321,0.5358138271990612,0.7590632016815589
15,15,18,9,0,9,9,9,0.5,-2.4372563154647926,0.658820171120614,0.34484990759820966,0.584774479375174
16,16,14,7,0,7,7,7,0.5,-0.3136863986628987,0.6044498929248825,0.5955905202909888,0.6998263887916887
18,18,14,7,0,7,7,7,0.5,-1.244970105879109,0.6122351514652434,0.6131658475205007,0.704479920282928
67,67,14,7,0,7,7,7,0.5,-0.36852848450981124,0.629627374236978,0.828683291159056,0.8852650246888254
77,77,14,7,0,7,7,7,0.5,-0.2797784740220675,0.5830970235037408,0.7631013865635836,0.7879886004194819
80,80,22,11,0,11,11,11,0.5,-2.7527910312499153,0.518936378952572,1.0645810284261719,0.9218458518090825
86,86,22,11,0,11,11,11,0.5,-1.4935401524245688,0.5150546047166078,0.8351044498841795,0.9795515658947991
99,99,14,7,0,7,7,7,0.5,-0.28252615724848334,0.5878885156756678,0.6827212619155084,0.7729177930958311
109,109,14,7,0,7,7,7,0.5,0.993752984090448,0.665282406006363,0.3541211750951269,0.45456477840562404
115,115,14,7,0,7,7,7,0.5,1.035229072399051,0.7135493451687666,0.28807038116012496,0.40975273826042524
118,118,14,7,0,7,7,7,0.5,0.16528439429528813,0.6913502734480055,0.531999489900752,0.746002360372716
121,121,18,9,0,9,9,9,0.5,-1.0600287887928639,0.5352570446229615,0.7328015775843668,0.8925370693718656
127,127,18,9,0,9,9,9,0.5,-1.631016202516133,0.5400860956922632,0.6066473556564473,0.7305749796499581
134,134,18,9,0,9,9,9,0.5,-3.5772149760109153,0.6376843322332149,0.3637684137787014,0.5827245356944178
135,135,18,9,0,9,9,9,0.5,-2.751092771053833,0.5995180242868461,0.7148643061184986,0.8796591359821767
141,141,14,7,0,7,7,7,0.5,-0.9954054501540818,0.662489569813952,0.422563052827256,0.5832049720499782
148,148,18,9,0,9,9,9,0.5,-2.703064207506486,0.6007643910213628,0.5664823070852721,0.7203513352126623
165,165,14,7,0,7,7,7,0.5,-0.3613549206179576,0.6472399972910069,1.2370963427666442,1.1488707970490908
179,179,18,9,0,9,9,9,0.5,-0.5390346606520281,0.5128451398022624,1.231530528327122,1.1384441777021914
183,183,14,7,0,7,7,7,0.5,-1.7975619794019193,0.7161794429968936,0.6983160750704156,0.988901395209982
190,190,14,7,0,7,7,7,0.5,-0.47963755246384304,0.6004432259311119,0.9054477272895659,1.0302977546703498
201,201,18,9,0,9,9,9,0.5,-0.6130815765902633,0.5443533937437636,0.8622896978901513,1.0567096677804886
216,216,14,7,0,7,7,7,0.5,-0.4010541173713013,0.6148712914074025,1.0151757513578568,0.8720958367388715
219,219,18,9,0,9,9,9,0.5,-0.47437013449605964,0.5607574172292895,1.4787176531805064,0.9512004418679898
222,222,18,9,0,9,9,9,0.5,-1.3155759068666792,0.5649183979375488,0.5334306193787035,0.7095135658864367
225,225,14,7,0,7,7,7,0.5,0.22913342110120397,0.6070469470408161,0.630195599272197,0.7736654405433728
226,226,18,9,0,9,9,9,0.5,0.34931827983981395,0.5890021702932006,0.5332206151693702,0.7694295620045724
237,237,14,7,0,7,7,7,0.5,0.5377544193044231,0.7115057616352735,0.5982823130769722,0.9129267278975668
247,247,18,9,0,9,9,9,0.5,-2.9118826539826705,0.663527486654124,0.7269450293742632,0.810419245560879
264,264,18,9,0,9,9,9,0.5,-3.1068279167578416,0.749887651092864,0.20508898179457896,0.41260481485717526
265,265,16,8,0,8,8,8,0.5,0.131737811225079,0.6102759014185403,0.4328653796810282,0.5652406793858776
282,282,20,10,0,10,10,10,0.5,-2.7865902708337225,0.559312528268854,0.43613179605244107,0.5795802234790199
297,297,14,7,0,7,7,7,0.5,-1.0548012759830774,0.7942654019292721,1.2472441333279705,1.2179814860992604
298,298,18,9,0,9,9,9,0.5,-1.1555030459042146,0.5756929655022582,0.7341267094821549,0.8401939943068454
300,300,16,8,0,8,8,8,0.5,1.8548663685438282,0.6015281765445087,0.8735819009270867,1.0981414548941097
309,309,16,8,0,8,8,8,0.5,3.080357355070576,0.7060871173314806,0.3173613216360968,0.5312587680268402
318,318,18,9,0,9,9,9,0.5,-0.8761474511151788,0.5699444801414735,0.5437490861141545,0.7243827623709476
319,319,14,7,0,7,7,7,0.5,-0.699924644910455,0.6596855546504568,1.1957254680797005,1.32535607769961
328,328,20,10,0,10,10,10,0.5,-0.13723798262843404,0.5709426280860367,0.6758723487149386,0.9836110849930608
335,335,14,7,0,7,7,7,0.5,0.18418511032160595,0.6370621742890507,0.6624806920582289,0.8509197821151401
337,337,14,7,0,7,7,7,0.5,-1.5041582869614039,0.6272091966210307,0.502491788620174,0.6353408239815307
346,346,14,7,0,7,7,7,0.5,-0.8628343309344003,0.6950400936348783,0.6476061178404142,0.97813203724759
362,362,30,15,0,15,15,15,0.5,-1.4909989313349312,0.4190972890977085,0.6344347021122275,0.7675448357144005
368,368,14,7,0,7,7,7,0.5,0.06486180018938191,0.6822335290970392,0.4783881463058163,0.6836441237324095
370,370,16,8,0,8,8,8,0.5,1.84826793555579,0.6219892256963393,0.5960248796969092,0.8565084978959379
372,372,16,8,0,8,8,8,0.5,0.4060260687193212,0.6034526845542881,0.6252216592298945,0.8552755814787316
382,382,16,8,0,8,8,8,0.5,0.7691535507936286,0.5922861494555128,0.5040376458215599,0.6457041026380286
411,411,14,7,0,7,7,7,0.5,-0.3628383745581065,0.6312775859349051,0.5754639798017251,0.7312949688798461
416,416,18,9,0,9,9,9,0.5,-3.3418865127267616,0.6406331759373498,0.33285603666654473,0.5058626032506256
425,425,14,7,0,7,7,7,0.5,0.7359432890513485,0.6187474609741692,2.100349195822791,1.1959514301073988
426,426,18,9,0,9,9,9,0.5,-2.7192149632702876,0.7587135905183262,0.20805921630735685,0.4363258966581466
427,427,18,9,0,9,9,9,0.5,-0.971548655671453,0.5653111009879542,0.8111234883644838,0.971383546279371
431,431,14,7,0,7,7,7,0.5,-0.9464725761561799,0.6489330419784306,0.6179444209270069,0.8521175585960549
434,434,14,7,0,7,7,7,0.5,-2.0554301041385763,0.5998489123495888,0.6275791158647929,0.7047754496677974
440,440,14,7,0,7,7,7,0.5,-0.7104332930905707,0.6369687223763176,0.6691964765964953,0.8327959774559155
442,442,14,7,0,7,7,7,0.5,0.6519875159565305,0.6745296458056237,0.37546373792305004,0.5192094590857672
447,447,14,7,0,7,7,7,0.5,0.6151197535604935,0.769849905209535,0.30648658102068876,0.5321838438353012
448,448,20,10,0,10,10,10,0.5,-0.2848788135486992,0.5681432478740323,0.7282531311253791,0.9528323749325978
473,473,18,9,0,9,9,9,0.5,-0.745517788267867,0.5304809395868709,0.6817234068204105,0.7475891005173974
474,474,18,9,0,9,9,9,0.5,-0.28919438897745176,0.5662849471709916,0.41304163255158793,0.5183144491125222
475,475,14,7,0,7,7,7,0.5,-0.9728397761285986,0.5915292900857319,1.2519439919023547,1.31783043466416
478,478,16,8,0,8,8,8,0.5,1.047106806502127,0.5693279101796173,0.6211718601153037,0.7422731776556597
480,480,18,9,0,9,9,9,0.5,-0.5524147909788024,0.5701701765013139,1.6868036867425464,1.5595912485447787
490,490,16,8,0,8,8,8,0.5,0.2669516909604921,0.666362490397676,0.26114584002467967,0.35182074722148726
494,494,14,7,0,7,7,7,0.5,-0.508241380725477,0.6786247677893029,0.8879214631594664,1.0114133474570943
496,496,16,8,0,8,8,8,0.5,0.10381392850306552,0.539083271745294,0.7340969934618469,0.7976485988566622
499,499,14,7,0,7,7,7,0.5,0.33352006153649727,0.6541468145464479,3.191845153320223,1.2695970517943704
500,500,14,7,0,7,7,7,0.5,0.2871174428119344,0.6127411398969682,0.5605724408907592,0.6850681881619202
512,512,14,7,0,7,7,7,0.5,-0.14581183917880322,0.6129470295956122,0.45289030578965417,0.5272458172916423
514,514,20,10,0,10,10,10,0.5,-1.655542466838878,0.5512447111967994,0.43816448308153894,0.6096535753509424
525,525,18,9,0,9,9,9,0.5,-1.034486488775638,0.5167755304166506,0.6898353362800127,0.7825790913877925
526,526,14,7,0,7,7,7,0.5,-0.8335270500270869,0.658657642098402,0.6221171885787492,0.7871917055432397
536,536,14,7,0,7,7,7,0.5,-0.04480472812039375,0.6290727391950366,0.5693369235964031,0.7288586627421506
572,572,18,9,0,9,9,9,0.5,-0.08557496668383789,0.5209558508977608,0.5953411454070605,0.6752531766870796
576,576,16,8,0,8,8,8,0.5,0.10042759980510314,0.6512547534640101,0.6925496280393465,0.967596087346305
597,597,14,7,0,7,7,7,0.5,-1.0414865344823727,0.5788581025424555,0.7442171317925244,0.7950016556251672
611,611,18,9,0,9,9,9,0.5,-0.5827984468813187,0.51761594461143845,0.7177324143381534,0.8034905688856312
617,617,22,11,0,11,11,11,0.5,-2.05648902046279,0.5395651843490412,0.40591858271341186,0.5765009966259476
620,620,18,9,0,9,9,9,0.5,3.310173715201728,0.6590728685568045,0.5539256919201816,0.9412854335502786
623,623,14,7,0,7,7,7,0.5,0.19424733649867118,0.6555991031524976,0.619089090490788,0.8301839284671978
624,624,18,9,0,9,9,9,0.5,5.473547137598568,0.7870714297619277,0.44488828210046033,0.9391884355641069
638,638,14,7,0,7,7,7,0.5,2.0335635798354557,0.6263327947988547,0.6260686052525388,0.743718304306002
642,642,18,9,0,9,9,9,0.5,-1.263389827107017,0.552549595278758,0.541386523998003,0.6715886259178248
645,645,14,7,0,7,7,7,0.5,3.435364384792395,0.8877194975294095,0.2113888359332796,0.4986780140411309
650,650,14,7,0,7,7,7,0.5,0.5743652047001573,0.5696244907914171,0.7972734103704686,0.8498827074749234
683,683,14,7,0,7,7,7,0.5,0.7261107053594646,0.6633802707406574,0.8386296591807986,1.0519275698205364
696,696,18,9,0,9,9,9,0.5,1.3854603340492846,0.5210295925994416,0.7706883352918765,0.8794644383663072
705,705,14,7,0,7,7,7,0.5,-0.13889654604924578,0.5972983032342516,0.6840659362436978,0.7455705174299865
708,708,16,8,0,8,8,8,0.5,1.0460247659776956,0.6355902572640948,0.4353753784851626,0.5937007673901682
711,711,18,9,0,9,9,9,0.5,1.625672833282946,0.5373899082522149,0.6887543452329861,0.8664530748944826
712,712,14,7,0,7,7,7,0.5,2.569272132702581,0.6357652077006172,0.9288399778704471,1.0948791502975599
715,715,18,9,0,9,9,9,0.5,-1.8699831436517629,0.7058570303157307,2.635381119626344,0.9009044983400379
719,719,14,7,0,7,7,7,0.5,-0.2310750276464623,0.5937627452714764,0.6287553414878939,0.7065592531017029
730,730,14,7,0,7,7,7,0.5,1.5341620780763439,0.5867664649393085,0.9519193774283732,0.9557198922876087
731,731,14,7,0,7,7,7,0.5,-1.117238899198035,0.7204422595868806,0.38836694170851116,0.6268528177452218
748,748,18,9,0,9,9,9,0.5,2.947899573776755,0.5891025531188261,0.7887404848848627,1.0764181009159293
761,761,14,7,0,7,7,7,0.5,1.350573673091736,0.6801790849161332,0.36996677557183916,0.52508971580419594
765,765,14,7,0,7,7,7,0.5,-1.1662538721517786,0.6432168859264805,0.44295640320258783,0.5546937729166815
773,773,14,7,0,7,7,7,0.5,-0.7491978896674533,0.6127003025753224,0.6272984311337161,0.7361640556777328
780,780,20,10,0,10,10,10,0.5,2.3657712837808003,0.5446465374698256,0.6071698723114156,0.7855745406159015
789,789,14,7,0,7,7,7,0.5,-0.03232253301848761,0.6173114546446214,1.55620428012936,1.1884237685913934
802,802,14,7,0,7,7,7,0.5,0.12537005988472882,0.6390824638828222,1.1067705164060126,1.2029466804405848
812,812,14,7,0,7,7,7,0.5,-0.6461457115766059,0.6655965697191725,0.8022076329574457,1.0252614951916306
817,817,14,7,0,7,7,7,0.5,1.7417819482854133,0.6978371441161779,0.8245812361503843,1.0109257728140677
819,819,14,7,0,7,7,7,0.5,3.789404667962879,0.8222185658715861,0.7878434529502866,1.193389363731968
822,822,20,10,0,10,10,10,0.5,0.33044194831696067,0.49740270225772487,0.8483554769623819,0.8688874788822657
823,823,16,8,0,8,8,8,0.5,1.1816392736669363,0.5792066124756797,0.6616761034043159,0.7734427031218172
854,854,18,9,0,9,9,9,0.5,-0.8976325519146721,0.5684214892883349,0.38924574595312617,0.4704809579267026
856,856,18,9,0,9,9,9,0.5,3.685685031321072,0.6668885244045155,2.230230760485088,1.4348135916513758
866,866,18,9,0,9,9,9,0.5,-1.0193422040425006,0.5399781842266153,0.8140050165909354,0.9077288737961807
867,867,14,7,0,7,7,7,0.5,0.662177356943031,0.6509337776515159,1.1841004186107382,1.36658347747219
881,881,14,7,0,7,7,7,0.5,-1.261806533576208,0.6610327100761246,0.6240880064045335,0.9038990519278606
891,891,18,9,0,9,9,9,0.5,-0.19545180351389033,0.5437371365178725,0.6589203925358498,0.782585527681623
897,897,14,7,0,7,7,7,0.5,2.9907423382661857,1.0514533847206908,0.16507582823347164,0.5051968478346015
901,901,14,7,0,7,7,7,0.5,1.9702379807675738,0.8250003809980928,0.628296954398646,1.1510403762415142
904,904,14,7,0,7,7,7,0.5,0.6879305251087259,0.6562204550164429,1.3193186600318367,0.9684075161863984
911,911,14,7,0,7,7,7,0.5,-1.1378982379479772,0.5794077601046674,0.7430109595075262,0.8138202873973253
925,925,16,8,0,8,8,8,0.5,3.490619559660339,0.6068416642267177,0.5429412542079151,0.7291612810720455
927,927,16,8,0,8,8,8,0.5,1.704527092637833,0.6944125513864284,0.4681776273860646,0.7283836858770468
931,931,20,10,0,10,10,10,0.5,0.9061855133040112,0.5825712450527196,0.6214068524646532,0.9140242636281962
41,41,19,9,0,10,9,9.015789473684212,0.47451523545706376,-4.897510427171882,0.6982194887992816,0.32946145710806285,0.6126787742848188
764,764,19,9,0,10,9,9.015789473684212,0.47451523545706376,2.6137881426631115,0.5579908851971038,0.8084095849617254,1.0274574481861651
813,813,17,8,0,9,8,8.01764705882353,0.4716262975778547,1.5539035720532581,0.5785186844774889,0.815526815963087,0.8255411744347937
98,98,13,6,0,7,6,6.023076923076923,0.4633136094674556,-4.936642489277719,0.9118858597748546,0.41175985226058975,0.7799906025211644
111,111,13,6,0,7,6,6.023076923076923,0.4633136094674556,-1.4987828773037644,0.6647608278898037,0.5366523385658362,0.698823168599146
311,311,13,6,0,7,6,6.023076923076923,0.4633136094674556,-1.0554106328306354,0.678794502216304,0.8182072806878486,0.9639992511625189
340,340,13,6,0,7,6,6.023076923076923,0.4633136094674556,-2.477331884454214,0.7873254418915585,0.26998976713800993,0.4615126151411698
450,450,13,6,0,7,6,6.023076923076923,0.4633136094674556,-0.27687311258556824,0.6747969049584107,0.7589907007516973,0.9459174966347875
487,487,13,6,0,7,6,6.023076923076923,0.4633136094674556,0.1782045451535313,0.6803860845712557,4.606787311844247,1.21135457330321
613,613,13,6,0,7,6,6.023076923076923,0.4633136094674556,0.6191464277795806,0.6450217841428765,0.4553880867170754,0.5537336947560846
660,660,13,6,0,7,6,6.023076923076923,0.4633136094674556,-2.5695871889324207,0.7824621654166597,0.3021313298179039,0.5204247951975625
672,672,13,6,0,7,6,6.023076923076923,0.4633136094674556,-0.21211787428258175,0.6480014621150005,0.7568407054977218,0.9287809944261389
678,678,13,6,0,7,6,6.023076923076923,0.4633136094674556,0.2326158350303494,0.6658357171991102,0.5637647074922458,0.7110442861773515
713,713,13,6,0,7,6,6.023076923076923,0.4633136094674556,1.368700601347666,0.7594823739491064,0.45327231204751767,0.7456727365325861
826,826,13,6,0,7,6,6.023076923076923,0.4633136094674556,-0.9233715547912438,0.7250580390344455,0.35129510006271414,0.5173255925807605
838,838,13,6,0,7,6,6.023076923076923,0.4633136094674556,-1.2258512223516782,0.7053164314493059,0.6635251634317882,0.9236416881845217
251,251,24,11,0,13,11,11.025,0.45937500000000003,-1.1897294165758154,0.4657333004817823,1.0248276148429205,1.041978215997772
373,373,22,10,0,12,10,10.027272727272727,0.45578512396694215,-2.6602665531783094,0.5192967606836756,1.0610340076931495,1.1047481778709938
410,410,22,10,0,12,10,10.027272727272727,0.45578512396694215,2.075828139634878,0.5150581615659907,2.872416511681598,1.2655678484035822
541,541,22,10,0,12,10,10.027272727272727,0.45578512396694215,-1.3338402134464804,0.4879829391387456,0.6772920083855428,0.8348025039351121
718,718,22,10,0,12,10,10.027272727272727,0.45578512396694215,1.2408865850000586,0.5081850284339346,0.5025843755575409,0.6239988943825064
64,64,20,9,0,11,9,9.030000000000001,0.45150000000000007,-1.7238312348050866,0.5778749088336268,0.4895256516007655,0.708707197825882
102,102,20,9,0,11,9,9.030000000000001,0.45150000000000007,-4.958165118985948,0.6290942221743924,0.3828188313919865,0.6742690428707186
138,138,20,9,0,11,9,9.030000000000001,0.45150000000000007,-2.181397431642328,0.5592964208609928,0.5784667017667461,0.8338403732334485
150,150,20,9,0,11,9,9.030000000000001,0.45150000000000007,-2.4252244754977803,0.5567621767039934,0.706990840700163,0.9587565927901996
159,159,20,9,0,11,9,9.030000000000001,0.45150000000000007,-3.037104199599791,0.5614527088434221,0.5311835981580199,0.7414229314210444
197,197,20,9,0,11,9,9.030000000000001,0.45150000000000007,-4.3623116996855,0.6704544115939266,0.4683819900991815,0.7492768854902615
221,221,20,9,0,11,9,9.030000000000001,0.45150000000000007,-0.8924584138368,0.5668244853164828,0.614306879078354,0.9147225274465471
223,223,20,9,0,11,9,9.030000000000001,0.45150000000000007,-0.012002386895395076,0.5620365737259063,1.6791021899305012,1.3086427539548138
232,232,20,9,0,11,9,9.030000000000001,0.45150000000000007,-3.446326710319346,0.6173375223951215,0.5942486948805407,0.9123399221583861
233,233,20,9,0,11,9,9.030000000000001,0.45150000000000007,-5.902394987335618,0.6504992606135571,0.5006863411079248,0.9241954989213107
239,239,20,9,0,11,9,9.030000000000001,0.45150000000000007,0.8968352704208092,0.5552586739801534,0.5362493997405101,0.7155166662211119
255,255,20,9,0,11,9,9.030000000000001,0.45150000000000007,-1.7360136200946574,0.5239973432284184,0.5366276910269407,0.6793560421214411
281,281,20,9,0,11,9,9.030000000000001,0.45150000000000007,-2.901121304907354,0.5371637192284112,0.6858935912560536,0.8272478341320413
296,296,20,9,0,11,9,9.030000000000001,0.45150000000000007,1.9948608704016917,0.6141254600344876,0.4150753117636013,0.69822473107906
299,299,20,9,0,11,9,9.030000000000001,0.45150000000000007,-1.2191061569328865,0.5311680947439938,0.5859509284075644,0.7331079568190482
360,360,20,9,0,11,9,9.030000000000001,0.45150000000000007,-0.8074753578404998,0.5473936962789603,0.9443107176646975,0.9212266762484919
366,366,20,9,0,11,9,9.030000000000001,0.45150000000000007,-3.295273062703595,0.6020389106521007,0.43060705643167746,0.6897864454082117
424,424,20,9,0,11,9,9.030000000000001,0.45150000000000007,-0.3010956493755555,0.555795948871587,0.5394489516749967,0.7350962108199928
668,668,20,9,0,11,9,9.030000000000001,0.45150000000000007,0.5501094490303542,0.5659825453303619,1.1948197724431033,1.1264197384580137
690,690,20,9,0,11,9,9.030000000000001,0.45150000000000007,2.655307761720005,0.5679268752708001,0.5793956000868988,0.8423222235644158
723,723,20,9,0,11,9,9.030000000000001,0.45150000000000007,3.8303083563337603,0.593004407504836,0.5601220481248603,0.8319311705059321
741,741,20,9,0,11,9,9.030000000000001,0.45150000000000007,0.8132184504273471,0.5140243689398952,1.1532082779469413,1.1040706435436396
785,785,20,9,0,11,9,9.030000000000001,0.45150000000000007,2.060022923654798,0.6363802835411164,0.3341120112284661,0.5426749685644128
820,820,20,9,0,11,9,9.030000000000001,0.45150000000000007,0.9207763023539368,0.5004213995613428,0.7030040151190816,0.8247838741427369
895,895,20,9,0,11,9,9.030000000000001,0.45150000000000007,2.137118789213159,0.5436622758223975,1.1894436162256956,0.9816372618638232
27,27,18,8,0,10,8,8.033333333333333,0.4462962962962963,-1.3605011415952921,0.5585517464976063,0.9327887824849108,1.0729662063290417
59,59,18,8,0,10,8,8.033333333333333,0.4462962962962963,-3.0347130808773195,0.643727296058986,0.3706945159575038,0.6145455031432833
161,161,18,8,0,10,8,8.033333333333333,0.4462962962962963,-0.8650564810138224,0.5746659338929431,2.749175078468799,1.3153457543715905
177,177,18,8,0,10,8,8.033333333333333,0.4462962962962963,-0.5165886336839669,0.6247683297710939,0.9431715675952087,1.035522227083928
178,178,18,8,0,10,8,8.033333333333333,0.4462962962962963,-5.66390764010206,0.7175282536926159,0.42483480086408315,0.8352947709637074
189,189,18,8,0,10,8,8.033333333333333,0.4462962962962963,-0.23754063376153078,0.5559308183710718,0.5002001639473169,0.6097453972803482
203,203,18,8,0,10,8,8.033333333333333,0.4462962962962963,-2.21639204292612,0.6383523687886636,0.42455553890332987,0.7209024829094707
230,230,18,8,0,10,8,8.033333333333333,0.4462962962962963,0.024267604537370376,0.6403716758332536,0.9025437190777443,1.057693902990647
275,275,18,8,0,10,8,8.033333333333333,0.4462962962962963,-0.04102657951799308,0.5426882061765681,0.5458452122534294,0.6460761989789947
306,306,18,8,0,10,8,8.033333333333333,0.4462962962962963,-1.5159094654925556,0.5492260646030721,0.5362102823616754,0.672175837286894
316,316,18,8,0,10,8,8.033333333333333,0.4462962962962963,-1.132571771084438,0.5497356206771166,0.5982126704897289,0.6993123562440676
327,327,18,8,0,10,8,8.033333333333333,0.4462962962962963,-2.8157236849895724,0.6940999689685917,0.3275145211603502,0.625705111279287
338,338,18,8,0,10,8,8.033333333333333,0.4462962962962963,-0.5148902000736009,0.5908682679946156,0.6096348696980277,0.8682886038238643
342,342,18,8,0,10,8,8.033333333333333,0.4462962962962963,-2.394993349591442,0.689512090208246,0.48094349301755,0.7787916343037067
349,349,18,8,0,10,8,8.033333333333333,0.4462962962962963,0.7695448001744322,0.5786951474388646,0.5273965596467374,0.7097007991662707
385,385,18,8,0,10,8,8.033333333333333,0.4462962962962963,-0.5739807087171441,0.6061245447243863,0.33698401846325526,0.4706467566667846
408,408,18,8,0,10,8,8.033333333333333,0.4462962962962963,-0.7777684966700481,0.5694625032753624,4.44654065174199,1.285774653015006
413,413,18,8,0,10,8,8.033333333333333,0.4462962962962963,-2.2536661507745337,0.6021534927156719,0.47079040170409253,0.6636703751869394
420,420,18,8,0,10,8,8.033333333333333,0.4462962962962963,-1.4324255050223567,0.5452404558436234,0.6661389850094463,0.8531430257591286
430,430,18,8,0,10,8,8.033333333333333,0.4462962962962963,0.7834487148230879,0.6167651527948086,0.8098693071409406,1.1081173388764447
437,437,18,8,0,10,8,8.033333333333333,0.4462962962962963,-0.4590198018492436,0.5299849523785175,0.7027982458636582,0.8327779018479388
457,457,18,8,0,10,8,8.033333333333333,0.4462962962962963,-1.2769765954994237,0.5432142965053552,0.5402484416459534,0.6489922438560212
468,468,18,8,0,10,8,8.033333333333333,0.4462962962962963,-0.6213425138297574,0.5545390137347612,0.6776427966299636,0.8374153662005674
488,488,18,8,0,10,8,8.033333333333333,0.4462962962962963,-0.49958036070127004,0.5569197815596041,1.2269137126260834,0.950999352149626
489,489,18,8,0,10,8,8.033333333333333,0.4462962962962963,-1.0736295046654418,0.5287761592351722,0.7395756307115176,0.8660472447672124
566,566,18,8,0,10,8,8.033333333333333,0.4462962962962963,-1.442475180645235,0.5739490681906352,0.5665775361851687,0.788908550105856
574,574,18,8,0,10,8,8.033333333333333,0.4462962962962963,-3.5617570112314936,0.5931776045255659,1.3144558409346927,1.06885880529427
581,581,18,8,0,10,8,8.033333333333333,0.4462962962962963,-0.8748542511499341,0.5337359781292581,0.5307070790538027,0.5999175106090466
590,590,18,8,0,10,8,8.033333333333333,0.4462962962962963,-0.36949797155665537,0.516642698745733,1.2618570980214026,1.1494904796439036
594,594,18,8,0,10,8,8.033333333333333,0.4462962962962963,0.5432534976361848,0.5730968265450609,0.938640968055174,0.9470421306345383
599,599,18,8,0,10,8,8.033333333333333,0.4462962962962963,-1.2693682026393063,0.542493665027998,1.3235115948613394,1.3167347379541123
636,636,18,8,0,10,8,8.033333333333333,0.4462962962962963,-1.2874379822227688,0.5332745690561724,0.8145456807374666,0.9434540643861048
679,679,18,8,0,10,8,8.033333333333333,0.4462962962962963,-1.0202374597403494,0.5735347239256348,0.7423860854747201,0.9692231157190414
684,684,18,8,0,10,8,8.033333333333333,0.4462962962962963,0.3601577374803883,0.5356229669126464,0.6515865626459706,0.7687282660883894
709,709,18,8,0,10,8,8.033333333333333,0.4462962962962963,-3.893260077476253,0.6162799765780643,0.4216394798860366,0.6477239605796618
756,756,18,8,0,10,8,8.033333333333333,0.4462962962962963,0.7946912418106945,0.59375853306508,0.5040440879429586,0.6338011414029666
769,769,18,8,0,10,8,8.033333333333333,0.4462962962962963,-0.9886414545812763,0.5539046876157679,0.6280504324488119,0.8023847137107103
774,774,18,8,0,10,8,8.033333333333333,0.4462962962962963,2.1449318583331176,0.6763418540099855,0.42261208903425834,0.6485448850400463
835,835,18,8,0,10,8,8.033333333333333,0.4462962962962963,0.018313442666211596,0.5617847638050206,0.8901600748994368,0.9793506941049318
906,906,18,8,0,10,8,8.033333333333333,0.4462962962962963,0.052850744147207036,0.6373455851794912,0.6279481746150581,0.7566582079177304
60,60,16,7,0,9,7,7.0375,0.43984375,0.15633645337106425,0.6159087063562371,1.3974909967777172,1.3415260563140063
85,85,16,7,0,9,7,7.0375,0.43984375,1.9869524014473017,0.6270127899478526,0.542685055849843,0.7003310440973263
204,204,16,7,0,9,7,7.0375,0.43984375,2.9893556296878323,0.6546542542795634,0.49942663654570274,0.6744916442937728
286,286,16,7,0,9,7,7.0375,0.43984375,1.241657500610846,0.6079909127199272,0.39285347941951254,0.4624307616649494
351,351,16,7,0,9,7,7.0375,0.43984375,1.1845678426439865,0.6056771364241078,1.6803033191689516,0.9555762572530573
518,518,16,7,0,9,7,7.0375,0.43984375,0.05687889575663526,0.6255011489949064,0.4134722831868851,0.5486516759420118
564,564,16,7,0,9,7,7.0375,0.43984375,0.33551590210169474,0.668057421338317,2.2172940472731906,1.1622460306802047
569,569,16,7,0,9,7,7.0375,0.43984375,0.016057191577909465,0.5943362904125973,1.0969509680263818,0.9945864785792119
610,610,16,7,0,9,7,7.0375,0.43984375,0.1043825143562313,0.6444177283012392,0.47374313139350205,0.6914296246509102
760,760,16,7,0,9,7,7.0375,0.43984375,1.8596772733412354,0.6728044288179776,0.35256709086817983,0.5079037469114893
768,768,16,7,0,9,7,7.0375,0.43984375,2.106437785067088,0.5838893085632666,0.6661968564938094,0.8209044568291541
956,956,16,7,0,9,7,7.0375,0.43984375,1.4360954096280127,0.6022113795284998,0.8633300318203686,1.0991536111945563
157,157,23,10,0,13,10,10.03913043478261,0.43648393194707,-1.4080485753710608,0.47780043731726635,1.2502239724384892,1.1235262384441183
10,10,14,6,0,8,6,6.042857142857143,0.4316326530612245,0.6273311217511266,0.591093421835011,0.5611822918527747,0.6208154515568839
22,22,14,6,0,8,6,6.042857142857143,0.4316326530612245,-2.2388755710962736,0.7330784532747332,0.9368470912216781,1.2496568805025676
43,43,14,6,0,8,6,6.042857142857143,0.4316326530612245,-0.08496647256630126,0.6305856187629011,0.7031389277753678,0.7928778339299307
47,47,14,6,0,8,6,6.042857142857143,0.4316326530612245,-1.505174353831726,0.6025813803961672,0.7550917585480044,0.8917397472863241
54,54,14,6,0,8,6,6.042857142857143,0.4316326530612245,-2.527617481099416,0.7018252059739077,0.31107519785473403,0.4213881993895618
62,62,14,6,0,8,6,6.042857142857143,0.4316326530612245,-0.9631572627956759,0.6041219126407712,0.6693168783402432,0.7422185745785037
90,90,14,6,0,8,6,6.042857142857143,0.4316326530612245,-2.0159697753411607,0.8071508854131255,0.2263490123641144,0.4028399760495351
107,107,14,6,0,8,6,6.042857142857143,0.4316326530612245,0.7208362480431632,0.6125960153026611,1.0353511344452964,1.0190094957907736
145,145,14,6,0,8,6,6.042857142857143,0.4316326530612245,-0.5998019790481969,0.5870824961737635,0.6985304399765179,0.7856093011485085
151,151,14,6,0,8,6,6.042857142857143,0.4316326530612245,-0.051599488337334284,0.6172379999638048,0.6996602155387784,0.8113601925193111
171,171,14,6,0,8,6,6.042857142857143,0.4316326530612245,-1.240785718811681,0.7649937266642637,0.3165453385756006,0.5692275725820259
180,180,14,6,0,8,6,6.042857142857143,0.4316326530612245,-1.766453160839268,0.6720006257394476,0.49882891408317576,0.7152182564388573
192,192,14,6,0,8,6,6.042857142857143,0.4316326530612245,-1.9951938158029165,0.6752306105611025,0.47179325698250135,0.6885907989749913
210,210,14,6,0,8,6,6.042857142857143,0.4316326530612245,-0.3317803266877381,0.6861804731188529,0.5528477618762289,0.6935337778513451
238,238,14,6,0,8,6,6.042857142857143,0.4316326530612245,-1.524126540484554,0.6880765875692596,0.7296395076068872,0.902283920035744
249,249,14,6,0,8,6,6.042857142857143,0.4316326530612245,0.8547989711986399,0.6866913342301645,0.48546887870673583,0.7128215876391149
263,263,14,6,0,8,6,6.042857142857143,0.4316326530612245,-1.615253022201474,0.6992624245846679,3.8373925843588887,1.2625792118392742
267,267,14,6,0,8,6,6.042857142857143,0.4316326530612245,0.19076243118184294,0.6874402600314539,0.7738409363335329,0.979581455763993
317,317,14,6,0,8,6,6.042857142857143,0.4316326530612245,0.1315075578560267,0.6741614885777406,0.32320862923070603,0.41915358537064384
336,336,14,6,0,8,6,6.042857142857143,0.4316326530612245,-1.8536316067528227,0.6424506531703852,0.36582188179699754,0.44191784606650775
345,345,14,6,0,8,6,6.042857142857143,0.4316326530612245,0.08391504658961212,0.7592906435855593,0.5384782204583918,0.8622625506890351
356,356,14,6,0,8,6,6.042857142857143,0.4316326530612245,-1.786464354329649,0.6513633831188443,0.5376075124766447,0.7339548037026853
371,371,14,6,0,8,6,6.042857142857143,0.4316326530612245,1.7105951400545194,0.6766855695904191,0.576915836980389,0.8171406683435155
401,401,14,6,0,8,6,6.042857142857143,0.4316326530612245,-1.8359361356531818,0.6065997197707103,0.9112195599846492,0.9436543815708356
404,404,14,6,0,8,6,6.042857142857143,0.4316326530612245,-0.8600978878052303,0.7350344189661786,0.44003123920246845,0.6977725406420727
405,405,14,6,0,8,6,6.042857142857143,0.4316326530612245,0.6897924066257127,0.5902520351670818,0.9692812609837992,0.9710491533827285
417,417,14,6,0,8,6,6.042857142857143,0.4316326530612245,-0.8920987393172175,0.6743108512415669,0.3897964110170506,0.51033047650986
441,441,14,6,0,8,6,6.042857142857143,0.4316326530612245,-0.5872542273093571,0.6816124575065383,0.5832995250615706,0.9063754029655181
464,464,14,6,0,8,6,6.042857142857143,0.4316326530612245,-0.38064623264971503,0.6593854320172102,9.518290402135282,1.4893216861365715
483,483,14,6,0,8,6,6.042857142857143,0.4316326530612245,-0.9430604828422018,0.6601028606896491,0.5404785019723503,0.7712434696784242
503,503,14,6,0,8,6,6.042857142857143,0.4316326530612245,-0.44431581825250255,0.5874706247558994,1.2705340302789823,1.1281457931240755
507,507,14,6,0,8,6,6.042857142857143,0.4316326530612245,-0.7109153275630093,0.6375551203213463,1.0043953951321234,1.021404411094533
519,519,14,6,0,8,6,6.042857142857143,0.4316326530612245,-0.3144588668137192,0.656464807512383,2.4799965468989695,1.6566044504787718
530,530,14,6,0,8,6,6.042857142857143,0.4316326530612245,0.30366897135636844,0.663549393866027,0.6124134427224285,0.8002766877683913
535,535,14,6,0,8,6,6.042857142857143,0.4316326530612245,-1.2580466487966917,0.5961331881531161,2.174107296169345,1.1260142798608992
542,542,14,6,0,8,6,6.042857142857143,0.4316326530612245,-1.9049960613012646,0.6875169064281678,0.45338713883658693,0.6555394232441218
548,548,14,6,0,8,6,6.042857142857143,0.4316326530612245,-0.5208278627321083,0.6231985139280543,0.6641400739022834,0.8270379684129763
588,588,14,6,0,8,6,6.042857142857143,0.4316326530612245,-1.029485165998759,0.6479126804842055,0.5257817099288195,0.6908271860935168
615,615,14,6,0,8,6,6.042857142857143,0.4316326530612245,-1.3945732763181564,0.633804941627442,0.6593964653855012,0.843246803841366
632,632,14,6,0,8,6,6.042857142857143,0.4316326530612245,-2.610139090565757,0.73860503906404,1.027323172203159,1.1524577092196282
643,643,14,6,0,8,6,6.042857142857143,0.4316326530612245,-1.055957923126893,0.6103573238184857,0.859065983812382,1.0046667014161177
698,698,14,6,0,8,6,6.042857142857143,0.4316326530612245,-2.4599908938453003,0.7088502921088166,0.34000418504586966,0.520188370994377
716,716,14,6,0,8,6,6.042857142857143,0.4316326530612245,0.8770675775412498,0.6738013001583228,0.451938585164794,0.6095036837309433
728,728,14,6,0,8,6,6.042857142857143,0.4316326530612245,-1.3720313360659655,0.6197216109569851,1.8072435403180067,1.0141148174585801
737,737,14,6,0,8,6,6.042857142857143,0.4316326530612245,0.5918300842459596,0.6471811574480438,1.2530996219471349,1.3420895149148526
740,740,14,6,0,8,6,6.042857142857143,0.4316326530612245,2.077128393407693,0.7005783222554967,0.33395110825797925,0.4912731573810914
771,771,14,6,0,8,6,6.042857142857143,0.4316326530612245,0.9069940535525979,0.6006407250641944,0.6270544323480375,0.690432174236597
777,777,14,6,0,8,6,6.042857142857143,0.4316326530612245,-0.718950080834098,0.6929622566944662,0.8512715833611753,1.1216747180101254
803,803,14,6,0,8,6,6.042857142857143,0.4316326530612245,-0.9848657109211179,0.6812738304310529,0.39525870757531795,0.5784272897966065
836,836,14,6,0,8,6,6.042857142857143,0.4316326530612245,-0.2976069274510293,0.6692030357246117,2.2455669258472466,1.2493684597134413
837,837,14,6,0,8,6,6.042857142857143,0.4316326530612245,-0.6320211866456366,0.6851507445160462,0.996290081931322,1.234335357274624
845,845,14,6,0,8,6,6.042857142857143,0.4316326530612245,-1.5371933532466855,0.6108618044881434,0.9625315603589543,1.020521580249279
883,883,14,6,0,8,6,6.042857142857143,0.4316326530612245,1.0796398813124826,0.726711132317471,0.30564137746982134,0.4789075065842082
888,888,14,6,0,8,6,6.042857142857143,0.4316326530612245,-0.6681273759791451,0.6323341707928309,0.4730664301053143,0.5877745420587587
981,981,14,6,0,8,6,6.042857142857143,0.4316326530612245,1.1127645994528146,0.7015448694215064,1.295817853098596,1.2234183013309312
722,722,26,11,0,15,11,11.046153846153846,0.42485207100591715,-1.9032615517295206,0.43694041257312727,0.8089241529484691,0.9513014899295967
304,304,19,8,0,11,8,8.047368421052632,0.42354570637119116,-0.7243225162607281,0.5132851136090795,1.372596476822947,1.1904606176304342
334,334,24,10,0,14,10,10.05,0.41875,-1.8981089084271465,0.4930738265250604,1.4355469480552374,1.223096743776501
220,220,17,7,0,10,7,7.052941176470587,0.41487889273356393,-2.3060674955122615,0.5748225047735503,2.8065518938053002,1.1540627106573693
227,227,17,7,0,10,7,7.052941176470587,0.41487889273356393,-0.5787499442694843,0.673090699385141,1.8273492071280497,1.1500014930721398
241,241,17,7,0,10,7,7.052941176470587,0.41487889273356393,-1.078770247101121,0.593222517548208,2.666010693321375,1.2480806259706236
252,252,17,7,0,10,7,7.052941176470587,0.41487889273356393,-0.6796422671157515,0.5882838236947903,2.822734003332343,1.5498285731190433
455,455,17,7,0,10,7,7.052941176470587,0.41487889273356393,1.0830999864463842,0.5993902646280049,1.0613241795875932,1.1488109361083647
603,603,17,7,0,10,7,7.052941176470587,0.41487889273356393,1.919320224529489,1.0467079372354327,0.2084721673852571,0.7653602769676751
750,750,17,7,0,10,7,7.052941176470587,0.41487889273356393,-0.6411936480989484,0.5396745948093086,0.6001594409103802,0.6781857234022068
285,285,22,9,0,13,9,9.054545454545455,0.4115702479338843,-1.8641047739988157,0.491199728944542,0.6999973106604013,0.8529694661769504
381,381,22,9,0,13,9,9.054545454545455,0.4115702479338843,0.2587827599806728,0.4686844573650236,0.9598731885636014,1.0204548929961945
125,125,20,8,0,12,8,8.06,0.403,-2.6611619234448916,0.5600943230319527,0.850573737936348,1.1488203758126363
160,160,20,8,0,12,8,8.06,0.403,-2.4340861887114214,0.5255400634661141,0.5490515604455467,0.7024524556212982
254,254,20,8,0,12,8,8.06,0.403,-1.6523334632171087,0.5235173967169247,0.8314625208119508,0.8773964666661527
261,261,20,8,0,12,8,8.06,0.403,-1.4173905117428187,0.5575720057722932,0.7421080391300781,0.9067943729272789
389,389,20,8,0,12,8,8.06,0.403,2.6229639413246826,0.6574174388318491,0.6440927650342061,0.9040662832135448
495,495,20,8,0,12,8,8.06,0.403,-2.32178028615603,0.5409948007480236,2.3463453511840617,1.7160833848033672
666,666,20,8,0,12,8,8.06,0.403,-1.1156951738898249,0.5323884871628269,0.9935627135171454,1.039851621712667
742,742,20,8,0,12,8,8.06,0.403,1.4897344927060416,0.6177374935401282,0.31574997580981234,0.4824112800407876
33,33,18,7,0,11,7,7.0666666666666655,0.39259259259259255,-5.4870294335477565,0.6666469393187638,0.4996427088997632,0.9147827794160343
53,53,18,7,0,11,7,7.0666666666666655,0.39259259259259255,-3.16804506713196,0.718099230192864,3.8337145663473575,1.1919367564972778
56,56,18,7,0,11,7,7.0666666666666655,0.39259259259259255,-3.6135845320433067,0.6247276419888662,6.644794591663633,1.0177125115527952
129,129,18,7,0,11,7,7.0666666666666655,0.39259259259259255,-2.320932016808924,0.5348086357777955,1.245509361800404,1.2391152087902235
149,149,18,7,0,11,7,7.0666666666666655,0.39259259259259255,-2.3467658416146753,0.5534290090319391,0.6100396980758072,0.8008443077113705
166,166,18,7,0,11,7,7.0666666666666655,0.39259259259259255,-0.7312956660812221,0.5902651270168009,0.8961275743814361,0.8331427098023697
188,188,18,7,0,11,7,7.0666666666666655,0.39259259259259255,0.17000278730220034,0.574599273670686,0.7006835485108341,0.760070882861095
244,244,18,7,0,11,7,7.0666666666666655,0.39259259259259255,-1.6660913677534155,0.5436991389025427,0.8259779591974363,0.9335002729272746
276,276,18,7,0,11,7,7.0666666666666655,0.39259259259259255,-0.20954345210602376,0.5412145411478714,0.7690683446036187,0.9053531249323464
278,278,18,7,0,11,7,7.0666666666666655,0.39259259259259255,-0.5015704209267197,0.5616089606457089,0.7126724555077882,0.8758035815603032
284,284,18,7,0,11,7,7.0666666666666655,0.39259259259259255,-1.3806282414096491,0.5515043071795219,0.8331670932203377,1.0172402190659846
322,322,18,7,0,11,7,7.0666666666666655,0.39259259259259255,-5.526612859469708,0.6880365744447897,0.26044904607232794,0.47161063566367734
341,341,18,7,0,11,7,7.0666666666666655,0.39259259259259255,-3.842487084811917,0.6049536238656987,0.4584292528179742,0.6670921137473522
354,354,18,7,0,11,7,7.0666666666666655,0.39259259259259255,-0.8348253038635864,0.5751194128632974,0.6023119822197167,0.8133462830056287
392,392,18,7,0,11,7,7.0666666666666655,0.39259259259259255,-2.217282121593454,0.5964989655905061,0.39018235074732716,0.546435309219427
479,479,18,7,0,11,7,7.0666666666666655,0.39259259259259255,-2.6443134406409925,0.6145773688943789,0.9473908335365265,1.0427191372732234
486,486,18,7,0,11,7,7.0666666666666655,0.39259259259259255,-2.477175195986965,0.5827021185114959,0.7354939047608192,0.8940331539797587
644,644,18,7,0,11,7,7.0666666666666655,0.39259259259259255,-1.3124275319690486,0.5693021826064808,0.7682902359455817,0.9661015588634999
673,673,18,7,0,11,7,7.0666666666666655,0.39259259259259255,-0.7658632338083217,0.5431320200483802,0.7406443591319231,0.9148808727714614
787,787,18,7,0,11,7,7.0666666666666655,0.39259259259259255,-2.9158893415542466,0.6079025112823117,0.44222249351364384,0.6712909879060724
808,808,18,7,0,11,7,7.0666666666666655,0.39259259259259255,-1.1744655151171155,0.5561248757511593,0.7970558987182126,0.952856828286673
877,877,18,7,0,11,7,7.0666666666666655,0.39259259259259255,2.1618292757241786,0.9625520417078647,0.2664542972016287,0.6647411313046763
945,945,18,7,0,11,7,7.0666666666666655,0.39259259259259255,8.39211677078437e-4,0.5506944108570665,0.9915263787247317,1.041967868787462
952,952,18,7,0,11,7,7.0666666666666655,0.39259259259259255,0.6651516423795895,0.6051952723258416,0.5864852071906679,0.8273428507538166
110,110,13,5,0,8,5,5.069230769230769,0.3899408284023668,-0.4197499304307562,0.86690893181700035,0.22096138006073102,0.4362401601777813
112,112,13,5,0,8,5,5.069230769230769,0.3899408284023668,-0.5114165111191573,0.7234444174214748,0.4693234383451061,0.7443959067152933
283,283,13,5,0,8,5,5.069230769230769,0.3899408284023668,-0.21773214899295157,0.7045394528287819,0.5608952849772247,0.7310219168910758
393,393,13,5,0,8,5,5.069230769230769,0.3899408284023668,-3.264770932339789,0.9090443578468437,0.17613856457270172,0.36322445679386123
396,396,13,5,0,8,5,5.069230769230769,0.3899408284023668,-1.6251615117268425,0.7079052767249638,0.6103178854702933,0.9189164590800741
403,403,13,5,0,8,5,5.069230769230769,0.3899408284023668,-2.020694649056515,0.6933481002854662,0.5023636866391713,0.692718971822629
465,465,13,5,0,8,5,5.069230769230769,0.3899408284023668,-2.146560499098795,0.7148750459868506,0.4434717589909958,0.670835433873478
510,510,13,5,0,8,5,5.069230769230769,0.3899408284023668,-0.13302921507412888,0.755010815048124,0.37411264193217725,0.628616869541448
516,516,13,5,0,8,5,5.069230769230769,0.3899408284023668,0.6268160511203936,0.7697736908995833,0.2304216091341907,0.32239520450661546
520,520,13,5,0,8,5,5.069230769230769,0.3899408284023668,-1.2090679328731389,0.6672533406043104,1.4695229261147686,1.4027537174188982
596,596,13,5,0,8,5,5.069230769230769,0.3899408284023668,-0.6097277441891069,0.6380549507184233,0.5950446789749282,0.7280262302177711
797,797,13,5,0,8,5,5.069230769230769,0.3899408284023668,-2.5109377245918174,0.7647142066166148,0.5999107709283581,0.8205439169810154
855,855,13,5,0,8,5,5.069230769230769,0.3899408284023668,-1.4745665718926215,0.6238494209375184,0.6603825763052952,0.7983865918420958
959,959,13,5,0,8,5,5.069230769230769,0.3899408284023668,-0.38256096231111336,0.7289920442603244,0.8445430947421888,0.9757689073107023
451,451,26,10,0,16,10,10.06923076923077,0.3872781065088758,-1.458516354372508,0.4334071254131132,0.7284895914160526,0.8254384638900606
274,274,21,8,0,13,8,8.071428571428571,0.3843537414965986,-4.403928662961421,0.6529300674294781,0.32015098681344345,0.6031360552260122
524,524,21,8,0,13,8,8.071428571428571,0.3843537414965986,-0.43980683657934266,0.5291783616614777,0.44127801898308094,0.5675764223006008
591,591,16,6,0,10,6,6.075,0.3796875,0.8425683615725126,0.6314124184446346,0.5592116948357072,0.781634134248356
601,601,16,6,0,10,6,6.075,0.3796875,0.06267006385974573,0.5800591083530579,0.48051976861203727,0.5772591089764926
19,19,24,9,0,15,9,9.075000000000001,0.37812500000000004,-1.8728948886609842,0.45500769481120046,0.7691556387962003,0.8979621067029975
193,193,24,9,0,15,9,9.075000000000001,0.37812500000000004,-0.9040575029202816,0.46754344188340213,0.8066841030646641,0.794997332350812
68,68,22,8,0,14,8,8.081818181818182,0.36735537190082646,-1.665467929643317,0.4738702276444454,1.0184151885888053,1.00220144078279
133,133,22,8,0,14,8,8.081818181818182,0.36735537190082646,-2.821575444433057,0.5730358028043071,1.549155639355613,1.359170816926998
253,253,22,8,0,14,8,8.081818181818182,0.36735537190082646,-2.097649640287862,0.5583790238736371,2.0634633323327165,1.24786158844437
423,423,22,8,0,14,8,8.081818181818182,0.36735537190082646,-1.0909297947309695,0.5056497094810298,1.3276650718333223,0.9901258914286877
12,12,14,5,0,9,5,5.085714285714285,0.36326530612244895,-1.505036526729193,0.6336646736774494,2.721346483540789,1.481122780199849
35,35,14,5,0,9,5,5.085714285714285,0.36326530612244895,-2.4746335586673993,0.6299005942437412,5.173346027448514,1.3702200624381957
76,76,14,5,0,9,5,5.085714285714285,0.36326530612244895,-1.0943092871707687,0.6224288890162015,0.7157388430257735,0.8148254674763038
92,92,14,5,0,9,5,5.085714285714285,0.36326530612244895,-1.8119217096645357,0.7904719428123672,0.24318320542783914,0.43096292436856193
103,103,14,5,0,9,5,5.085714285714285,0.36326530612244895,-1.4331995086362785,0.6409318502468647,0.9521224148361858,1.0289557958004325
106,106,14,5,0,9,5,5.085714285714285,0.36326530612244895,-0.41880484973840176,0.7352141167843365,0.6894811205824658,0.8835534478621802
158,158,14,5,0,9,5,5.085714285714285,0.36326530612244895,-0.1309787648350835,0.7031843122911722,2.070408218379005,1.1888759666309112
172,172,14,5,0,9,5,5.085714285714285,0.36326530612244895,-1.5533886742093994,0.6138545007424752,0.8390311370615667,0.9776860923448579
174,174,14,5,0,9,5,5.085714285714285,0.36326530612244895,-1.4639177551193916,0.6433802759517211,0.6319112890643943,0.8594688447407499
196,196,14,5,0,9,5,5.085714285714285,0.36326530612244895,-1.6871277367353834,0.6662551481836853,0.3984222973557405,0.5534585693545706
242,242,14,5,0,9,5,5.085714285714285,0.36326530612244895,-2.018687079763567,0.6599837953493369,1.7948314570712414,1.2825841588238478
257,257,14,5,0,9,5,5.085714285714285,0.36326530612244895,-1.2127587337871317,0.622800212151211,0.9879691777722366,1.1229097626843774
262,262,14,5,0,9,5,5.085714285714285,0.36326530612244895,-1.5401383975044323,0.6576537112316505,0.5356517294923233,0.7025575864910658
266,266,14,5,0,9,5,5.085714285714285,0.36326530612244895,-1.5745542340506469,0.6803535364633198,0.4320336051745012,0.6275342852909334
314,314,14,5,0,9,5,5.085714285714285,0.36326530612244895,-2.2712240134558597,0.6979355495685944,0.9253191072989375,1.0817831643290465
315,315,14,5,0,9,5,5.085714285714285,0.36326530612244895,-2.230555864589266,0.7005766181280104,0.6799122481632566,1.0174414173337212
332,332,14,5,0,9,5,5.085714285714285,0.36326530612244895,-1.9198696808705558,0.6769662899871413,1.4292985721938898,1.2679698389918317
339,339,14,5,0,9,5,5.085714285714285,0.36326530612244895,-1.5976210302645806,0.6761439875552938,1.5669951545827157,1.4003702958206241
347,347,14,5,0,9,5,5.085714285714285,0.36326530612244895,-1.7618676912038842,0.6566132121370395,0.6607586916282965,0.8547669406284825
386,386,14,5,0,9,5,5.085714285714285,0.36326530612244895,-2.435617025694335,0.7227704200629073,0.5179484981298197,0.7948935220274901
414,414,14,5,0,9,5,5.085714285714285,0.36326530612244895,-0.49360051343846756,0.6760706391602668,1.5123127519595676,1.158471268689378
422,422,14,5,0,9,5,5.085714285714285,0.36326530612244895,-2.0217583665855843,0.691151181816229,0.3503259520060694,0.5090419979330217
438,438,14,5,0,9,5,5.085714285714285,0.36326530612244895,-2.3625265116342664,0.7014524253250791,0.826599942583073,1.0079056517511982
497,497,14,5,0,9,5,5.085714285714285,0.36326530612244895,0.6072487073220546,0.6753228404788358,0.9385805395521499,0.8902598744725551
533,533,14,5,0,9,5,5.085714285714285,0.36326530612244895,0.13204242805758024,0.7239339130987845,0.3591339361358475,0.5889179134017475
538,538,14,5,0,9,5,5.085714285714285,0.36326530612244895,-1.009337693171302,0.6527461228392025,0.36345949779519277,0.4517785008398117
554,554,14,5,0,9,5,5.085714285714285,0.36326530612244895,-1.1741007700348876,0.6391421610917992,1.161200258145762,1.2061299288018377
560,560,14,5,0,9,5,5.085714285714285,0.36326530612244895,-1.2465228774712191,0.5792183663269529,0.6599421820820923,0.7236605185841234
571,571,14,5,0,9,5,5.085714285714285,0.36326530612244895,-0.4803315112240619,0.6214331153573551,1.1950877077312292,1.032140752488266
573,573,14,5,0,9,5,5.085714285714285,0.36326530612244895,-0.3946366729644245,0.6798661559469001,0.5548454675839702,0.8287764058581272
607,607,14,5,0,9,5,5.085714285714285,0.36326530612244895,-1.1765183845306808,0.6603979814751659,0.47421914710786084,0.6482766828367706
612,612,14,5,0,9,5,5.085714285714285,0.36326530612244895,0.08398492453345832,0.840722960614021,0.27714888125056475,0.5780194287292684
621,621,14,5,0,9,5,5.085714285714285,0.36326530612244895,-0.7645642485046231,0.626764421539417,1.006286575001681,1.0859709221286624
686,686,14,5,0,9,5,5.085714285714285,0.36326530612244895,-1.6193834402795169,0.6486697779279811,0.7376832818848916,0.8800554776388673
704,704,14,5,0,9,5,5.085714285714285,0.36326530612244895,-1.168883890008322,0.6408992519840001,0.823590270246763,0.9284664346966891
739,739,14,5,0,9,5,5.085714285714285,0.36326530612244895,-0.7838844325640387,0.7062924624262722,0.47162548312733577,0.7219495051593373
899,899,14,5,0,9,5,5.085714285714285,0.36326530612244895,0.5718983149580033,0.6802395887176913,0.5947447491528352,0.7971136660239776
477,477,28,10,0,18,10,10.085714285714287,0.3602040816326531,-2.079303070376961,0.45691265487136984,0.7289096668620813,0.9016073662944222
154,154,17,6,0,11,6,6.088235294117647,0.35813148788927335,-3.7752259699587154,0.6132209664497942,0.8524867169769424,1.1425679818410965
289,289,17,6,0,11,6,6.088235294117647,0.35813148788927335,-2.7322642102819947,0.6092016858313893,0.47579947301553505,0.6612070224179858
310,310,17,6,0,11,6,6.088235294117647,0.35813148788927335,-0.3475679799910108,0.8293746056567332,3.3290840755567523,1.0826539386499872
63,63,20,7,0,13,7,7.089999999999999,0.3544999999999999,-2.9459376083759494,0.6062006423319286,2.05708371163693,1.0120688620462963
432,432,20,7,0,13,7,7.089999999999999,0.3544999999999999,-3.777261074112673,0.586259695730042,0.4744025345275281,0.7482889031962493
561,561,20,7,0,13,7,7.089999999999999,0.3544999999999999,-2.9448208778733873,0.5544785383237437,0.5063640772962756,0.7366805643924742
661,661,20,7,0,13,7,7.089999999999999,0.3544999999999999,-6.609555244558104,0.6501348959463801,0.4029339582007597,0.7672686539591884
24,24,18,6,0,12,6,6.1,0.33888888888888885,-4.239286446180928,0.6289263851846502,0.4631180407058214,0.756753638326825
30,30,18,6,0,12,6,6.1,0.33888888888888885,-6.7633154151160095,0.7403323952429874,0.2629216571677105,0.5402585525366139
51,51,18,6,0,12,6,6.1,0.33888888888888885,-6.223474169941198,0.6420075896915179,0.45360288142845584,0.779776407464939
66,66,18,6,0,12,6,6.1,0.33888888888888885,-2.3720128937847367,0.5644333015285272,0.47525062951190566,0.611823443709595
95,95,18,6,0,12,6,6.1,0.33888888888888885,-8.942955797083124,0.9470374249939563,0.5398249309781851,1.293624202571674
140,140,18,6,0,12,6,6.1,0.33888888888888885,-4.408918695806773,0.6553060861736167,0.46263659868613494,0.7745053247902843
146,146,18,6,0,12,6,6.1,0.33888888888888885,-3.5442665645468034,0.6152820795571107,0.5536782082431824,0.8219542204187902
169,169,18,6,0,12,6,6.1,0.33888888888888885,-2.201007938261547,0.6195908407530303,0.6314578643207456,0.8273073376452033
170,170,18,6,0,12,6,6.1,0.33888888888888885,-3.596747895793358,0.5774022926081338,0.6238184812559806,0.7977465458166757
176,176,18,6,0,12,6,6.1,0.33888888888888885,-5.207796030944902,0.732611921961324,0.3020379611287656,0.6399476748900108
181,181,18,6,0,12,6,6.1,0.33888888888888885,-2.8809689103120686,0.5812937159853097,0.533482584858313,0.7047324785148592
182,182,18,6,0,12,6,6.1,0.33888888888888885,-1.8451877686107137,0.5827107407378692,0.5711585412074933,0.7326296418790382
195,195,18,6,0,12,6,6.1,0.33888888888888885,-5.159021746823358,0.6557289837095391,0.47171125642471856,0.8510166974746252
199,199,18,6,0,12,6,6.1,0.33888888888888885,-3.79391541675433,0.6186069718618925,7.600647421217273,1.1964886024817978
211,211,18,6,0,12,6,6.1,0.33888888888888885,-1.9803766140123849,0.6239996458627184,1.9072536870567878,1.0786537761746158
213,213,18,6,0,12,6,6.1,0.33888888888888885,-2.056588205849517,0.6907721530767283,0.3056593042219027,0.5577344815688124
215,215,18,6,0,12,6,6.1,0.33888888888888885,-4.975156006680784,0.8022510177824198,0.24403661911196506,0.5696013527890851
217,217,18,6,0,12,6,6.1,0.33888888888888885,-2.4570195047074965,0.6214821947546552,20.00368639806429,1.1355632136036702
218,218,18,6,0,12,6,6.1,0.33888888888888885,-6.748596105319723,0.7861898445714662,0.23455765155650601,0.5652404874229808
228,228,18,6,0,12,6,6.1,0.33888888888888885,-8.78484675106218,0.8661909235284296,0.11680622007060183,0.2491269924016608
248,248,18,6,0,12,6,6.1,0.33888888888888885,-1.867069944126912,0.5509620650338856,1.1049517548638608,1.0819271274123805
277,277,18,6,0,12,6,6.1,0.33888888888888885,-1.0734366863587674,0.6200301625765062,0.8843772613794534,0.986771543696522
348,348,18,6,0,12,6,6.1,0.33888888888888885,0.039926132093799235,0.5613405634971164,0.5766355929430994,0.7402645937072718
380,380,18,6,0,12,6,6.1,0.33888888888888885,-4.635072661144321,0.6896141455016886,0.3608227840962056,0.6746492851726213
415,415,18,6,0,12,6,6.1,0.33888888888888885,-2.793136468450553,0.5356930534884408,1.1511262809995473,1.1592762001544783
527,527,18,6,0,12,6,6.1,0.33888888888888885,-1.2239718242618018,0.5656197560725569,0.7563198115164218,0.8634234572731455
558,558,18,6,0,12,6,6.1,0.33888888888888885,-0.15509069371074097,0.5399365393347542,1.087510938013417,1.0246484668697622
602,602,18,6,0,12,6,6.1,0.33888888888888885,-1.8645409271637075,0.615155251362112,0.6968502305594206,0.9836570488569905
619,619,18,6,0,12,6,6.1,0.33888888888888885,-1.2366109158895475,0.6604057700246374,2.4085970521439792,0.8650395444009013
627,627,18,6,0,12,6,6.1,0.33888888888888885,-1.678926417242793,0.597326406645289,1.3727356606496075,1.1439161630442638
654,654,18,6,0,12,6,6.1,0.33888888888888885,-0.8952265076407746,0.5601961004696244,0.928293705765389,1.0865019574050747
13,13,22,7,0,15,7,7.1090909090909085,0.32314049586776855,-3.3205852285175865,0.5575043759867041,2.413716269175269,1.0897567121485683
273,273,22,7,0,15,7,7.1090909090909085,0.32314049586776855,-3.0994322892750223,0.529054593850858,0.5030599931860791,0.6975013881260056
78,78,13,4,0,9,4,4.115384615384616,0.31656804733727817,-2.12870861181027,0.726668856080031,0.31369543051606513,0.44203366326094934
143,143,13,4,0,9,4,4.115384615384616,0.31656804733727817,-3.142121561768093,0.7920554567721823,4.795761143611149,1.2881567544793473
214,214,13,4,0,9,4,4.115384615384616,0.31656804733727817,-2.470420528830503,0.7102879317433011,0.6502312866289848,0.8706621815115733
224,224,13,4,0,9,4,4.115384615384616,0.31656804733727817,-4.999578222143698,0.9910539266622412,0.1440115295282457,0.337789295749067
245,245,13,4,0,9,4,4.115384615384616,0.31656804733727817,-1.7342621736795056,0.6590336419410645,0.5257726613574596,0.6593368847515916
271,271,13,4,0,9,4,4.115384615384616,0.31656804733727817,-0.3755848119340435,0.6925215856221366,0.4594162242259866,0.6462550278975117
364,364,13,4,0,9,4,4.115384615384616,0.31656804733727817,-1.7749262365082878,0.6839797901852623,0.39835358558295175,0.5235691963779517
384,384,13,4,0,9,4,4.115384615384616,0.31656804733727817,-2.9013861715905014,0.8267811669613028,0.2178172714715558,0.3723580055435003
409,409,13,4,0,9,4,4.115384615384616,0.31656804733727817,-3.377163174186302,0.8436524045166847,0.33011148262829954,0.6973631414997855
470,470,13,4,0,9,4,4.115384615384616,0.31656804733727817,-3.480522711826339,0.8246271069284102,0.30479502930487085,0.5952461397418441
549,549,13,4,0,9,4,4.115384615384616,0.31656804733727817,-3.4328660437007175,0.8415668483597996,0.35607472713255495,0.7543484741012914
563,563,13,4,0,9,4,4.115384615384616,0.31656804733727817,-3.2088846057003457,0.7381889607090655,0.3296818014255146,0.5006003375317335
57,57,20,6,0,14,6,6.119999999999999,0.30599999999999994,-7.806644943392158,0.6166698823231305,0.49223238479477766,0.8753976208641312
72,72,20,6,0,14,6,6.119999999999999,0.30599999999999994,-4.080718532807716,0.5731073828818386,0.8147427241774917,1.0468705046959879
87,87,20,6,0,14,6,6.119999999999999,0.30599999999999994,-3.7241445785791307,0.572044140795522,2.0184390450428333,0.9829925165953394
136,136,20,6,0,14,6,6.119999999999999,0.30599999999999994,-6.848315780407477,0.6879134719468543,0.30977296703783785,0.5989000464453783
152,152,20,6,0,14,6,6.119999999999999,0.30599999999999994,-4.947752629789685,0.6387691375293467,0.5229889250495313,0.8969512551540173
205,205,20,6,0,14,6,6.119999999999999,0.30599999999999994,-3.5729853407128096,0.5834580091409627,0.6375352211317227,0.9353661844809253
260,260,20,6,0,14,6,6.119999999999999,0.30599999999999994,-6.020773976234239,0.658249582566849,0.36751692714758255,0.7286853278376814
608,608,20,6,0,14,6,6.119999999999999,0.30599999999999994,-1.8002819056868362,0.5734412968290122,0.44479055480029717,0.6368875313225403
688,688,20,6,0,14,6,6.119999999999999,0.30599999999999994,-1.925152445640125,0.5621970588514573,0.7445726577769509,0.8378341630643439
779,779,20,6,0,14,6,6.119999999999999,0.30599999999999994,1.5013177076518693,0.5844917821061691,0.46012718302706423,0.602870461748569
84,84,17,5,0,12,5,5.1235294117647054,0.30138408304498265,-2.521469559297783,0.6158051305788487,1.1614353965403854,1.2942389447428657
142,142,17,5,0,12,5,5.1235294117647054,0.30138408304498265,-2.1012708027310723,0.7009752888192746,0.28516769156025873,0.5064779871167291
444,444,17,5,0,12,5,5.1235294117647054,0.30138408304498265,0.1378218718889851,0.7770104388700406,0.1666908048884427,0.28433889877762936
17,17,14,4,0,10,4,4.128571428571429,0.2948979591836735,-0.9808847236564351,0.63997108452992,0.7417403055391991,0.8874825219807958
119,119,14,4,0,10,4,4.128571428571429,0.2948979591836735,-1.3625726008494363,0.686164394323098,0.7939303074112741,1.028076407885534
126,126,14,4,0,10,4,4.128571428571429,0.2948979591836735,-2.2676213003094525,0.7226941126328978,1.2884984090244718,1.3108326533366663
173,173,14,4,0,10,4,4.128571428571429,0.2948979591836735,-1.7206950278448394,0.6895475017688579,1.6523564081458837,0.8675259115552133
229,229,14,4,0,10,4,4.128571428571429,0.2948979591836735,-2.0830041637084706,0.8101303059687238,0.6308920279236963,0.7525797053906403
243,243,14,4,0,10,4,4.128571428571429,0.2948979591836735,-1.7223088842267853,0.6865159187305651,1.5409760222628452,1.2911247098772063
250,250,14,4,0,10,4,4.128571428571429,0.2948979591836735,-1.3767805659594436,0.9932007622419484,0.15304778041494752,0.4189263409587369
288,288,14,4,0,10,4,4.128571428571429,0.2948979591836735,-1.4052392218075795,0.7529006272565806,0.4361733476646344,0.7699623166026871
378,378,14,4,0,10,4,4.128571428571429,0.2948979591836735,-2.4401863752232384,0.8409362402325483,0.37377279956924003,0.7179260326261927
402,402,14,4,0,10,4,4.128571428571429,0.2948979591836735,-1.0447766281326698,0.7456944984905147,0.4010859336111593,0.6988732439032463
482,482,14,4,0,10,4,4.128571428571429,0.2948979591836735,-0.6700548703185675,0.6876792633834297,0.4885318151913321,0.6582660210770996
506,506,14,4,0,10,4,4.128571428571429,0.2948979591836735,-1.8766856438125594,0.7430205644065216,0.43350985825856153,0.6843007686436512
534,534,14,4,0,10,4,4.128571428571429,0.2948979591836735,-1.0046360907242469,0.6405065094673604,2.8659607768715922,1.357633723922885
570,570,14,4,0,10,4,4.128571428571429,0.2948979591836735,-1.1729200473701749,0.6702066438321744,1.730545610555043,1.1149421824619385
578,578,14,4,0,10,4,4.128571428571429,0.2948979591836735,-0.22241888103314308,0.7501669468574365,0.9976279032712195,0.8037909958125633
14,14,18,5,0,13,5,5.133333333333333,0.28518518518518515,-3.9318439304472186,0.6032762474683728,0.461910346403459,0.7105253042817381
46,46,18,5,0,13,5,5.133333333333333,0.28518518518518515,-4.258116432705072,0.7153432581815937,0.24721696594841155,0.45667337640942396
52,52,18,5,0,13,5,5.133333333333333,0.28518518518518515,-3.8512674848941724,0.671560266852132,0.2646375557833702,0.44477071113033706
71,71,18,5,0,13,5,5.133333333333333,0.28518518518518515,-3.4559118324145013,0.6322252535236134,0.4460188355841286,0.6799381010916146
73,73,18,5,0,13,5,5.133333333333333,0.28518518518518515,-7.243953969411335,0.8915843934891114,4.6847945037354934,2.6276929543062635
75,75,18,5,0,13,5,5.133333333333333,0.28518518518518515,-1.414927070381635,0.6032779711505529,1.0000136646561328,1.1858239721332227
81,81,18,5,0,13,5,5.133333333333333,0.28518518518518515,-5.759533402122429,0.7091685856372867,0.49334190180801546,0.8074290098188363
89,89,18,5,0,13,5,5.133333333333333,0.28518518518518515,-1.0156670786814626,0.5669160822078053,1.0459172520465845,0.9321697942285575
91,91,18,5,0,13,5,5.133333333333333,0.28518518518518515,-3.3240088167553457,0.6288113662810275,0.6166803770667916,0.907466933659995
93,93,18,5,0,13,5,5.133333333333333,0.28518518518518515,-4.064795078833165,0.6454516941170226,0.6922641785648947,0.9976953659220729
97,97,18,5,0,13,5,5.133333333333333,0.28518518518518515,-3.0175678779142907,0.6214044740243801,4.400239010525819,1.276490484934022
117,117,18,5,0,13,5,5.133333333333333,0.28518518518518515,-5.1138228067186535,0.6721523618887921,0.6775044725237614,1.111259053978511
123,123,18,5,0,13,5,5.133333333333333,0.28518518518518515,-4.090100578623253,0.6157252537449744,0.6671620372937791,1.0055676153555122
144,144,18,5,0,13,5,5.133333333333333,0.28518518518518515,-2.4307725549129384,0.6548596748593294,0.41485618309136696,0.699951812924988
147,147,18,5,0,13,5,5.133333333333333,0.28518518518518515,-3.651972078215165,0.6916630681185064,0.25250162381992475,0.43402909799921846
156,156,18,5,0,13,5,5.133333333333333,0.28518518518518515,-0.8098242258936283,0.625521239681608,4.592889510139751,0.8823522581683886
272,272,18,5,0,13,5,5.133333333333333,0.28518518518518515,-4.063429381168155,0.6068710237139753,0.44871827350593474,0.6850503500496005
320,320,18,5,0,13,5,5.133333333333333,0.28518518518518515,-3.2183184029638396,0.6159833582541271,2.889981710597428,1.4440934707133932
321,321,18,5,0,13,5,5.133333333333333,0.28518518518518515,-2.4526464233198015,0.6674632601053895,0.4388608624741724,0.6961338499384743
323,323,18,5,0,13,5,5.133333333333333,0.28518518518518515,-2.442458925907028,0.6107132613939942,0.8893652280209695,0.9141418394933976
387,387,18,5,0,13,5,5.133333333333333,0.28518518518518515,-1.9288298432360544,0.6572074340914451,1.7306966562072805,1.2465026635253442
653,653,18,5,0,13,5,5.133333333333333,0.28518518518518515,-1.019119883137262,0.5518913289326624,2.1764678461823332,1.018014217169988
55,55,22,6,0,16,6,6.136363636363635,0.2789256198347107,-4.239856741745331,0.5800371111826491,0.5371262674176721,0.8748928518021938
79,79,22,6,0,16,6,6.136363636363635,0.2789256198347107,-2.6330224967366984,0.5528145009876448,2.7261096826576927,0.9274483468099095
236,236,26,7,0,19,7,7.138461538461538,0.27455621301775146,-2.3274748903901976,0.5059224052387207,1.1831805343808766,0.9544696202780902
312,312,19,5,0,14,5,5.1421052631578945,0.2706371191135734,-8.118181854849784,0.7071352299913699,0.33502228476540086,0.7476649367636022
40,40,20,5,0,15,5,5.1499999999999995,0.25749999999999995,-6.430249063790712,0.7642063784508669,0.2615945422302027,0.720825046039395
83,83,20,5,0,15,5,5.1499999999999995,0.25749999999999995,-7.58973256796924,0.658580616160742,0.4952979000286392,0.9141272822507256
104,104,20,5,0,15,5,5.1499999999999995,0.25749999999999995,-0.9158513445310537,0.6046175892474958,0.4327132219565593,0.6816450591871541
113,113,20,5,0,15,5,5.1499999999999995,0.25749999999999995,-6.569801509044666,0.5980045930448391,0.4568132116092837,0.7635470194197193
122,122,20,5,0,15,5,5.1499999999999995,0.25749999999999995,-5.835101373737656,0.6342481063231039,0.5000516357225248,0.8742556734160537
124,124,20,5,0,15,5,5.1499999999999995,0.25749999999999995,-5.093265002411837,0.6469091915619886,0.43167013344037597,0.8081930776228164
167,167,20,5,0,15,5,5.1499999999999995,0.25749999999999995,-8.048530995870834,0.6104046378254739,0.43126286962370664,0.7515891750963508
191,191,20,5,0,15,5,5.1499999999999995,0.25749999999999995,-4.854053948682878,0.6550103190169372,0.4490793300094193,0.7263269357803217
240,240,20,5,0,15,5,5.1499999999999995,0.25749999999999995,-3.2609121165366624,0.5981982008608587,0.4959806947201087,0.7425970016118215
25,25,17,4,0,13,4,4.158823529411764,0.24463667820069201,-3.796539307802925,0.8397747180933769,1.7758740772643886,0.8588144672084932
36,36,17,4,0,13,4,4.158823529411764,0.24463667820069201,-4.161911446703958,0.743769179861099,3.945376468252413,0.965432475603227
131,131,17,4,0,13,4,4.158823529411764,0.24463667820069201,-4.5780015322193055,0.7800987393904304,1.039226464414437,0.888855105281977
212,212,17,4,0,13,4,4.158823529411764,0.24463667820069201,-1.4273130081876584,0.6260853276964564,0.45263089205969004,0.6899016674472794
307,307,17,4,0,13,4,4.158823529411764,0.24463667820069201,-2.2538406628603322,0.5975225910346174,0.9777548053257396,1.0442662190177008
34,34,13,3,0,10,3,3.1615384615384614,0.24319526627218935,-3.8873379102684145,0.8059499157782903,0.29470183809344036,0.5345630401536631
101,101,13,3,0,10,3,3.1615384615384614,0.24319526627218935,-8.085012103215451,1.3283727384415462,0.07025886374823372,0.25583573633730944
155,155,13,3,0,10,3,3.1615384615384614,0.24319526627218935,-3.747024215223625,0.8312964299181416,2.4237968206397635,1.5710049752293787
184,184,13,3,0,10,3,3.1615384615384614,0.24319526627218935,-6.0559783317118745,0.9466610214730684,0.29003665594197336,0.7710418287957439
313,313,13,3,0,10,3,3.1615384615384614,0.24319526627218935,-2.1186394971566576,0.8138454322792478,4.6650540252042845,1.0467131258132099
546,546,13,3,0,10,3,3.1615384615384614,0.24319526627218935,-0.9152242258588699,0.7289327168234179,0.7211703278342504,0.9263848163860227
200,200,22,5,0,17,5,5.163636363636363,0.23471074380165288,-1.9848548555452814,0.5407365301317689,1.242021618235015,1.1201178373858183
579,579,22,5,0,17,5,5.163636363636363,0.23471074380165288,-3.106267494529501,0.548840429201043,1.1418527025798026,1.0993376481412578
82,82,18,4,0,14,4,4.166666666666666,0.23148148148148145,-8.74180077739813,0.831946663107783,0.3917966828897965,0.8236976954052511
153,153,18,4,0,14,4,4.166666666666666,0.23148148148148145,-4.317404100790927,0.6251076956384738,0.5192206443908302,0.76172691659277
168,168,18,4,0,14,4,4.166666666666666,0.23148148148148145,-6.179917236127584,0.679700851376049,0.508983733897242,0.8841766176948161
187,187,18,4,0,14,4,4.166666666666666,0.23148148148148145,-4.0293203195944285,0.6993640584039138,0.9848650179108868,1.127031050313522
194,194,18,4,0,14,4,4.166666666666666,0.23148148148148145,-5.058171137741651,0.6432448978736974,0.5878575369802984,0.850104759376319
235,235,18,4,0,14,4,4.166666666666666,0.23148148148148145,-4.414370746469674,0.6403055393506876,15.03141123102909,1.187404467008286
367,367,18,4,0,14,4,4.166666666666666,0.23148148148148145,-4.015564644877172,0.6439524760668687,0.560424306364962,0.8580395116793066
399,399,18,4,0,14,4,4.166666666666666,0.23148148148148145,-6.184771237267699,0.8160237895499401,0.19611316430027356,0.47018296301311224
501,501,18,4,0,14,4,4.166666666666666,0.23148148148148145,-2.495308229545721,0.6862223207538667,1.6959169846999977,1.1134566291564731
31,31,14,3,0,11,3,3.1714285714285713,0.22653061224489796,-2.444941490981515,0.7577307215712517,0.9516004016537444,1.1401186464557782
446,446,14,3,0,11,3,3.1714285714285713,0.22653061224489796,-1.3860190198121791,0.7993262929304032,0.3869901181819326,0.6921890210541785
515,515,14,3,0,11,3,3.1714285714285713,0.22653061224489796,-1.938385831763885,0.7780281268653891,2.724721004757879,1.6238319958063308
598,598,14,3,0,11,3,3.1714285714285713,0.22653061224489796,-1.4523309077794222,0.7920391250247782,0.4465210726789611,0.7313186243352304
302,302,23,5,0,18,5,5.1695652173913045,0.22476370510396976,-4.671017214013859,0.5911218397842225,1.0220558343240307,0.9848544325267361
130,130,24,5,0,19,5,5.175,0.21562499999999998,-2.8563612207575986,0.5299769971470816,1.6014985111755318,0.8902263510298464
21,21,20,4,0,16,4,4.18,0.209,-5.453929145549936,0.6584201811534647,8.724803510834167,1.2722974590996534
32,32,20,4,0,16,4,4.18,0.209,-5.807471886581865,0.7143532736891626,0.5001695830152662,0.9345205732530388
50,50,20,4,0,16,4,4.18,0.209,-1.7351285343396359,0.6091888781293339,2.9196019145881396,1.1496442459798193
303,303,17,3,0,14,3,3.1941176470588233,0.18788927335640138,-10.452197022706025,0.8487936193158313,0.28194706812676196,0.786061142978483
28,28,18,3,0,15,3,3.1999999999999997,0.17777777777777776,-5.6365922499115655,0.8285457185206238,2.541639499790909,0.9596110722220008
29,29,18,3,0,15,3,3.1999999999999997,0.17777777777777776,-5.260250320012476,0.7298688006733451,0.85450745640437,0.7438349663289716
38,38,18,3,0,15,3,3.1999999999999997,0.17777777777777776,-7.668528138030811,0.8449471435311413,0.17647273525974758,0.43864073653474195
39,39,18,3,0,15,3,3.1999999999999997,0.17777777777777776,-8.427318691065512,0.7575151039316419,0.31901656229633585,0.7102859571406576
42,42,18,3,0,15,3,3.1999999999999997,0.17777777777777776,-4.1099713592364395,0.7542004428233818,2.162347033596153,1.0669781837977028
48,48,18,3,0,15,3,3.1999999999999997,0.17777777777777776,-9.516798813341708,0.89519229874654,0.1413306793984811,0.4156161353926928
70,70,18,3,0,15,3,3.1999999999999997,0.17777777777777776,-4.3594276897979265,0.7602886156270596,0.5980000075107603,0.7926061943743091
88,88,18,3,0,15,3,3.1999999999999997,0.17777777777777776,-10.06988736469652,0.8026933472135853,0.3893286663799804,0.9306891551945147
108,108,18,3,0,15,3,3.1999999999999997,0.17777777777777776,-6.621834179279429,0.7413699701793379,0.37844652812061685,0.7760900479478564
120,120,18,3,0,15,3,3.1999999999999997,0.17777777777777776,-8.113681513253992,0.8224039597259051,0.2123686697485186,0.5892539816241182
137,137,18,3,0,15,3,3.1999999999999997,0.17777777777777776,-4.598203855828747,0.711044277952655,1.057970823160196,1.1116424019883082
258,258,18,3,0,15,3,3.1999999999999997,0.17777777777777776,-4.170160019800482,0.6760419373877082,0.6027413938868454,0.7558733472164447
407,407,18,3,0,15,3,3.1999999999999997,0.17777777777777776,-3.8403597117496067,0.6803309137516457,5.994862472824476,1.297058474988372
37,37,13,2,0,11,2,2.207692307692308,0.1698224852071006,-7.358374520452398,0.9499755334184418,0.4773239257237407,1.154890921177011
58,58,13,2,0,11,2,2.207692307692308,0.1698224852071006,-6.953394709379785,1.1460410181881504,0.10799263643985298,0.3371450388276938
74,74,13,2,0,11,2,2.207692307692308,0.1698224852071006,-2.7946208240657833,0.8580974112088833,0.9324054590833344,1.0681768507161722
94,94,13,2,0,11,2,2.207692307692308,0.1698224852071006,-6.882707977314946,0.9706415316524248,0.3268981464556809,0.7800553554782897
164,164,13,2,0,11,2,2.207692307692308,0.1698224852071006,-6.186612370378682,0.900952925717635,0.674770966723837,1.2963211087555964
329,329,13,2,0,11,2,2.207692307692308,0.1698224852071006,-2.9791681482660466,0.9340775933335004,1.2178125599800036,0.974304717545382
357,357,13,2,0,11,2,2.207692307692308,0.1698224852071006,-1.840008027901054,0.8683782789725506,1.3428191024461849,1.0611926011475519
279,279,24,3,0,21,3,3.224999999999999,0.13437499999999997,-5.005049998622877,0.6235525592061658,0.8337213572973347,1.0037227774378668
186,186,17,2,0,15,2,2.229411764705882,0.1311418685121107,-6.990762719785964,1.206554199214913,0.06931318125654998,0.30122316978622476
65,65,18,2,0,16,2,2.233333333333333,0.12407407407407406,-5.424401583872825,0.8317016861505886,2.66835603852883,1.0676802466143136
246,246,18,2,0,16,2,2.233333333333333,0.12407407407407406,-8.641240202191343,0.9139216586648213,0.24847823067648564,0.6688203558358354
406,406,18,2,0,16,2,2.233333333333333,0.12407407407407406,-4.412124525087579,0.8064855581746785,0.41533492470282335,0.6832192854891928
824,824,18,2,0,16,2,2.233333333333333,0.12407407407407406,-3.78082615811793,0.7554027110387269,535.7896888244013,1.1358889096192133
49,49,13,1,0,12,1,1.2538461538461538,0.09644970414201183,-5.273045274512954,1.0234845365256289,8.104291190640078,1.3421024190786448
23,23,18,1,0,17,1,1.2666666666666666,0.07037037037037036,-11.242213218015833,1.2595435162262418,0.05310367132087636,0.2256878426617152
44,44,18,1,0,17,1,1.2666666666666666,0.07037037037037036,-10.757851703416486,1.0796035988940103,0.14282281392836582,0.6543596616940429
69,69,13,0,0,13,0,0.3,0.023076923076923075,-9.983486193553402,1.93964410045835,0.026148938605750426,0.1298703399442588
324,324,13,0,0,13,0,0.3,0.023076923076923075,-12.327156758829453,2.0607035091614105,0.02974487182578785,0.27519974913979606
26,26,14,0,0,14,0,0.3,0.02142857142857143,-12.41640681373324,1.8924328615883528,0.02313102429126154,0.0756411675141764
