individual,id,Ntot,N1,ND,N0,raw,score,propscore,theta,se.theta,outfit,infit
155,113,12,11,0,1,11,10.750000000000002,0.8958333333333335,3.7681045985900785,1.002541832966402,0.6227743761291952,0.9749849844606835
73,50,16,14,0,2,14,13.775,0.8609375,3.495568446771102,0.7677669221566396,0.3522544674832677,0.6592700771554724
25,12,14,12,0,2,12,11.785714285714286,0.8418367346938777,3.609998181726881,0.8567851890617152,0.2938894131055485,0.6725530385720576
153,111,14,12,0,2,12,11.785714285714286,0.8418367346938777,3.8930068318914497,0.7878859047084017,2.3298918855187183,1.4169399980196
152,110,13,11,0,2,11,10.792307692307693,0.8301775147928995,2.999039146536603,0.8508972077601884,0.29149313869266424,0.5698415922337827
76,53,11,9,0,2,9,8.80909090909091,0.8008264462809919,2.1737835498174873,0.8576244162253972,0.5081563760861741,0.6857108183781728
140,99,11,9,0,2,9,8.80909090909091,0.8008264462809919,2.41426910357143,0.8171064598631489,0.705579663293932,1.0500497789899554
88,59,16,13,0,3,13,12.812500000000002,0.8007812500000001,0.570770384551461,0.7432964449693189,0.5172421868138641,0.8796751349448686
50,36,15,12,0,3,12,11.820000000000002,0.7880000000000001,1.4101458171216366,0.7078555157378672,0.4859933451584776,0.7752096627732735
121,85,10,8,0,2,8,7.82,0.782,3.257957460582097,0.9098293916732495,0.24468581385190652,0.40518675062865006
72,49,19,15,0,4,15,14.826315789473686,0.7803324099722992,3.5380483346007017,0.5991903221618309,0.7791950743026118,1.0426104628938908
75,52,14,11,0,3,11,10.82857142857143,0.7734693877551021,1.0347364113724649,0.8255746870766314,2.9189661081762996,1.1250553685771842
86,57,13,10,0,3,10,9.838461538461539,0.7568047337278107,3.5560105000929774,0.7259056948286953,0.4897244732340656,0.7784199502290843
148,107,16,12,0,4,12,11.850000000000001,0.7406250000000001,-1.2768056365765863,0.7381542577794487,0.3663902588609524,0.5832066231314894
22,9,12,9,0,3,9,8.850000000000001,0.7375000000000002,2.133448934730435,0.722658951210519,41.92958521021331,1.6072799071025903
47,33,12,9,0,3,9,8.850000000000001,0.7375000000000002,1.077940333797156,0.7488023623075772,0.4351892019785952,0.6095415931559179
58,42,12,9,0,3,9,8.850000000000001,0.7375000000000002,1.3218586567608708,0.81270233406642,0.9651166361006309,1.325670592371351
110,76,12,9,0,3,9,8.850000000000001,0.7375000000000002,-0.5499440078583316,0.8002562260913735,0.4837596877539105,0.6813368520582844
114,80,12,9,0,3,9,8.850000000000001,0.7375000000000002,1.1659069708270284,0.7273071856679206,1.4703802381522504,1.0782765951504576
145,104,12,9,0,3,9,8.850000000000001,0.7375000000000002,1.491164612794787,0.7704602926304509,0.42618179085191005,0.6689645011552541
154,112,12,9,0,3,9,8.850000000000001,0.7375000000000002,1.992192477906583,0.7165311856701484,2.0244101894960482,1.159328403795202
168,119,12,9,0,3,9,8.850000000000001,0.7375000000000002,3.0704397373008137,0.7911830856101554,0.7951000427938549,0.9266257740897634
105,73,8,6,0,2,6,5.8500000000000005,0.7312500000000001,2.5415809221401884,0.8908268293917883,1.126612921701784,1.4601112592951808
8,6,19,14,0,5,14,13.857894736842104,0.7293628808864265,1.8768439463008926,0.5402405034920884,1.164933904570005,1.1545298878887007
77,54,19,14,0,5,14,13.857894736842104,0.7293628808864265,2.3690028781990455,0.5675799218972851,0.8259461728972157,0.7924957558910124
131,93,15,11,0,4,11,10.860000000000001,0.7240000000000001,3.1923721992173903,0.6414128397350839,0.8530799268336069,0.9962429084730458
135,96,11,8,0,3,8,7.863636363636363,0.7148760330578512,2.332048645808504,0.7919175880455838,0.46472478537727163,0.5866041361873618
225,163,11,8,0,3,8,7.863636363636363,0.7148760330578512,2.743127636369843,0.7610022997480913,0.6597786220783998,0.8868445433252202
33,20,18,13,0,5,13,12.866666666666667,0.7148148148148148,1.9701287284656415,0.6301021284869281,0.9633496807683873,1.0931680944273272
96,67,18,13,0,5,13,12.866666666666667,0.7148148148148148,3.1566829913104852,0.5996926959642243,0.6677985411622588,0.9185981173971963
116,82,17,12,0,5,12,11.876470588235295,0.6986159169550173,1.3030731460052503,0.6573870733739151,0.8150977135107249,1.1028683906953851
113,79,19,13,0,6,13,12.889473684210527,0.678393351800554,0.9765803116887407,0.5676275012462155,1.3053530959293789,1.5148947038981913
187,130,15,10,0,5,10,9.9,0.66,-0.9030112938225695,0.7164923719912729,1.8192741407211561,1.2942793531812087
109,75,12,8,0,4,8,7.9,0.6583333333333333,1.2649147401377376,0.7184135663928634,0.8660956860553367,1.1437997946324057
37,24,9,6,0,3,6,5.9,0.6555555555555556,1.6235466751742467,0.8437536879756042,1.227085848292701,1.4261078670569012
175,123,20,13,0,7,13,12.91,0.6455,1.718929911491693,0.523536402672603,0.7040432938595189,0.8927194276715541
97,68,17,11,0,6,11,10.911764705882351,0.6418685121107266,1.7790011509136794,0.5557854660512233,0.5312335028674856,0.6316368896841121
224,162,17,11,0,6,11,10.911764705882351,0.6418685121107266,0.9391866045638639,0.6304787958607546,0.9076151481813447,1.063183570400638
195,137,14,9,0,5,9,8.914285714285716,0.6367346938775512,1.7243267470801218,0.6144863481762648,0.66056022490318,0.7955185816214264
230,168,14,9,0,5,9,8.914285714285716,0.6367346938775512,1.373338354533307,0.6940407238434343,0.478899216317375,0.5831104158599419
147,106,11,7,0,4,7,6.918181818181818,0.6289256198347107,0.3613570257849324,0.7335245771885244,0.743073838699241,0.8334080520327619
4,3,19,12,0,7,12,11.921052631578947,0.6274238227146814,2.3549042677235237,0.5571968045130922,1.4233308676761467,0.9787283884191661
24,11,16,10,0,6,10,9.925,0.6203125,2.318697990954108,0.5946944758283521,1.1033963898743497,1.0366467185102752
64,44,16,10,0,6,10,9.925,0.6203125,1.3617918391451038,0.5904599135223343,0.7716872434796134,0.9220773363995748
74,51,16,10,0,6,10,9.925,0.6203125,2.462043847710796,0.6147263701306002,1.324261189961708,1.2195804836587218
41,28,8,5,0,3,5,4.925,0.615625,0.49170574744691814,0.8685666058650899,3.087023314668255,1.5190037012067572
71,48,18,11,0,7,11,10.933333333333334,0.6074074074074074,1.3035488247268219,0.6015718947344529,0.63053021283706,0.8480070791700233
122,86,20,12,0,8,12,11.94,0.597,0.8982437960145248,0.5528971148410698,0.5977401560425603,0.6769896718596411
149,108,15,9,0,6,9,8.94,0.596,0.04804317314108404,0.6218481317624229,1.0060562553555628,1.2032566969595315
65,45,10,6,0,4,6,5.94,0.5940000000000001,1.0359907322140798,0.8482047082545798,0.2244488366457622,0.2644253649659974
95,66,10,6,0,4,6,5.94,0.5940000000000001,1.6636764016637593,0.7480110323208538,0.37412172986690867,0.430915498402857
103,71,10,6,0,4,6,5.94,0.5940000000000001,1.3937510722610829,0.8043993765967038,0.8650671766780281,1.1693127269866639
125,89,17,10,0,7,10,9.947058823529412,0.585121107266436,2.0210115010381946,0.5458527802579695,0.8966728881384072,0.9921950822447779
137,98,17,10,0,7,10,9.947058823529412,0.585121107266436,1.5294581867034602,0.6235904451197386,0.9791648664550533,1.2427532103855385
2,1,12,7,0,5,7,6.949999999999999,0.5791666666666666,-0.39745958478571847,0.7185452481714518,1.2295662812307373,0.9639363277466888
182,128,12,7,0,5,7,6.949999999999999,0.5791666666666666,1.299695652594486,0.6935271377634751,0.7155949812708969,0.8654914655567172
208,147,12,7,0,5,7,6.949999999999999,0.5791666666666666,-0.7823714575047654,0.6358750617002262,1.390825916166067,1.4020545253282408
115,81,19,11,0,8,11,10.952631578947368,0.5764542936288088,2.1167614414169424,0.4936175084367147,0.6974541639100631,0.7537862648103911
23,10,14,8,0,6,8,7.957142857142857,0.5683673469387756,0.506879519065898,0.7400661470972524,0.3143435802539054,0.5151970392370187
55,39,14,8,0,6,8,7.957142857142857,0.5683673469387756,0.7980859455830378,0.6422829791927823,2.134029162264852,1.1027206415554551
111,77,14,8,0,6,8,7.957142857142857,0.5683673469387756,-1.6152457862003509,0.7078537476258753,0.49195286936645244,0.7284293938791485
181,127,14,8,0,6,8,7.957142857142857,0.5683673469387756,0.9613256572240523,0.6191820897631473,1.0637470922544667,1.2194730842308035
200,140,14,8,0,6,8,7.957142857142857,0.5683673469387756,-0.9250265740924067,0.7410620862602394,0.5567170276854518,0.8081497273583206
45,31,16,9,0,7,9,8.9625,0.56015625,1.772887223947179,0.5491138564238427,0.6112025530086101,0.6890615704374649
7,5,18,10,0,8,10,9.966666666666667,0.5537037037037037,-1.6840896702383563,0.5806881158978646,0.8880410900004937,1.0659823011329634
89,60,18,10,0,8,10,9.966666666666667,0.5537037037037037,0.09832778977987519,0.5570948156860889,2.0422852894311045,1.2596801339883814
170,121,9,5,0,4,5,4.966666666666667,0.5518518518518518,2.691135607097333,0.7833413757484587,0.5594516534926348,0.6360200769954555
169,120,20,11,0,9,11,10.969999999999999,0.5485,1.8662231756315746,0.494889759014321,1.1490423042676348,1.1013624080839297
27,14,11,6,0,5,6,5.972727272727273,0.5429752066115703,1.1514032742652625,0.792107405789539,0.2898971475908853,0.38973662798013325
124,88,13,7,0,6,7,6.976923076923076,0.5366863905325443,1.3963800471354741,0.7088120354410846,0.3701831275771206,0.5215124734166037
190,132,13,7,0,6,7,6.976923076923076,0.5366863905325443,1.3026893688575862,0.6664771176648087,1.0718674405573918,1.0952523474647566
21,8,15,8,0,7,8,7.98,0.532,0.8163891155419306,0.5717702351390667,0.9528533026250962,1.064017317552686
108,74,15,8,0,7,8,7.98,0.532,1.7195505218188856,0.5669542307278858,1.2105664753374559,1.270986115771547
134,95,15,8,0,7,8,7.98,0.532,-1.576572746081374,0.6147126696416393,0.5304918247073593,0.6809037211056111
192,134,15,8,0,7,8,7.98,0.532,1.6774092022026115,0.5560314727160772,1.3401155295733493,1.2854485002335145
90,61,17,9,0,8,9,8.98235294117647,0.5283737024221453,-0.2948358611176319,0.5983854873740354,1.0084238749334338,1.287116868958225
120,84,17,9,0,8,9,8.98235294117647,0.5283737024221453,-0.5290294803981258,0.6176410800269092,0.4822522966565906,0.6626489443035466
49,35,19,10,0,9,10,9.98421052631579,0.5254847645429364,0.6637610436755587,0.5358079772762343,1.1208198230936646,0.9471012019333037
63,43,19,10,0,9,10,9.98421052631579,0.5254847645429364,0.90398303776788,0.6138264506735714,0.39045442095666766,0.5672172572380247
212,151,19,10,0,9,10,9.98421052631579,0.5254847645429364,0.5213336788593409,0.5323970524467044,0.7393861463537932,0.8491010629598051
3,2,16,8,0,8,8,8,0.5,0.9613370259544255,0.6019887235336988,0.860904958907175,0.9984371653010057
39,26,16,8,0,8,8,8,0.5,0.7530142248284571,0.5441551406345396,1.4266931708482464,1.0484649107518846
56,40,18,9,0,9,9,9,0.5,1.0577715867704511,0.5240748817521382,0.8260487636776113,0.9069835898441224
119,83,14,7,0,7,7,7,0.5,0.5979414591656277,0.6448808811348207,0.7138049144980653,0.8905712311406614
146,105,14,7,0,7,7,7,0.5,0.16041432739045494,0.6046967406277546,0.4981499009765974,0.5560662736021463
211,150,18,9,0,9,9,9,0.5,0.3478318746700031,0.5799855095266299,0.9918190735826862,0.9918075405284723
218,157,18,9,0,9,9,9,0.5,0.4903979172339411,0.569963507423361,0.47031674063893525,0.6102274965894136
226,164,10,5,0,5,5,5,0.5,0.6878595801056379,0.6766192541825646,1.013795729182436,1.0434073751364377
93,64,17,8,0,9,8,8.01764705882353,0.4716262975778547,-0.8433426610269609,0.6054209725191689,0.9115779450787352,0.9450990085406668
46,32,15,7,0,8,7,7.02,0.46799999999999997,0.14148674081042695,0.57223252713225925,0.6678690726259833,0.7724270649479781
128,91,15,7,0,8,7,7.02,0.46799999999999997,-1.0366502693809345,0.6016589835395185,1.0681992719143623,1.1378011493390416
167,118,15,7,0,8,7,7.02,0.46799999999999997,0.11846294457286242,0.5916613599601982,0.5163434990713631,0.6143227038366387
207,146,15,7,0,8,7,7.02,0.46799999999999997,-2.3631357976818483,0.5683506965227761,1.3994611957300198,1.38889082445202
215,154,15,7,0,8,7,7.02,0.46799999999999997,0.3980396271697486,0.5612047128953409,1.3173909160212496,1.152308218538403
220,159,15,7,0,8,7,7.02,0.46799999999999997,-1.2216858449169112,0.6826016901828478,0.29200838167562565,0.4074507226813272
40,27,13,6,0,7,6,6.023076923076923,0.4633136094674556,0.9063932388707656,0.6089532452651948,0.837222809226059,0.9125940184111241
69,46,13,6,0,7,6,6.023076923076923,0.4633136094674556,0.6221699522409833,0.6328033628369293,0.8807962725905238,0.8164811711306098
79,56,13,6,0,7,6,6.023076923076923,0.4633136094674556,-2.0930382077755096,0.6446818210283913,0.4088061413564836,0.47592903702266615
87,58,13,6,0,7,6,6.023076923076923,0.4633136094674556,0.5277247868218844,0.6683791352399595,1.2214399705621726,1.356695753374799
126,90,11,5,0,6,5,5.027272727272727,0.4570247933884298,0.1756221979442823,0.7397239037857567,0.7800805165307753,0.9967188228465049
141,100,11,5,0,6,5,5.027272727272727,0.4570247933884298,0.19810200484594812,0.6720732306617812,1.169034521318016,1.1037804644321587
223,161,11,5,0,6,5,5.027272727272727,0.4570247933884298,-1.431311165493224,0.7176331185035089,0.7780670390622404,0.9188879669601301
228,166,11,5,0,6,5,5.027272727272727,0.4570247933884298,0.18774662954427568,0.7620758833639506,1.113231323453268,1.3439299145327117
44,30,9,4,0,5,4,4.033333333333333,0.44814814814814813,-0.6849012412980817,0.7764419751012849,0.508841167695302,0.6146369920793391
171,122,16,7,0,9,7,7.0375,0.43984375,0.10030791554691006,0.573987282506237,0.9156298470564421,1.0439208124624357
203,143,7,3,0,4,3,3.042857142857143,0.43469387755102046,-1.8429595842010043,0.9873338031311012,1.1098791447736034,1.2870577413569637
136,97,14,6,0,8,6,6.042857142857143,0.4316326530612245,-0.41891890336654036,0.6481800306383593,0.736031411985299,0.9106352507660155
31,18,19,8,0,11,8,8.047368421052632,0.42354570637119116,-2.135394688727037,0.5072120447686683,0.902443977035395,0.9472015616395819
132,94,12,5,0,7,5,5.05,0.42083333333333334,-1.8712998107510987,0.7388085526305724,0.5323963350995086,0.7476517711605406
193,135,12,5,0,7,5,5.05,0.42083333333333334,-2.402691609595192,0.6828450044834488,2.4448800257642005,1.4388775929986406
205,144,12,5,0,7,5,5.05,0.42083333333333334,-0.454084159713185,0.7195966764127206,1.840323179617669,1.0909756260114212
34,21,24,10,0,14,10,10.05,0.41875,-0.24692246440090762,0.5091383785254616,0.8840812170443008,1.0114947754498136
184,129,17,7,0,10,7,7.052941176470587,0.41487889273356393,-2.925122041130946,0.5793435511026801,0.9214175083928514,1.0638984495715875
29,16,22,9,0,13,9,9.054545454545455,0.4115702479338843,-3.087389919129279,0.5569672832971604,0.8785143788762404,1.0818444189991412
78,55,10,4,0,6,4,4.0600000000000005,0.406,0.7156575166729225,0.7801305270669183,0.5760464748428479,0.721594307189217
104,72,10,4,0,6,4,4.0600000000000005,0.406,0.874358584393079,0.8163082400398897,0.6879902663471915,0.8636856761377941
6,4,15,6,0,9,6,6.0600000000000005,0.404,0.3925830059387018,0.6297534766419909,0.7468038773644665,0.9195333652636457
130,92,15,6,0,9,6,6.0600000000000005,0.404,0.5693722636656893,0.5922772352226143,0.5476806934633878,0.65200825988814
198,138,15,6,0,9,6,6.0600000000000005,0.404,-1.072136026673257,0.6256676087537922,0.9854362403374443,1.2037828268475779
123,87,20,8,0,12,8,8.06,0.403,-0.4147506628545403,0.6153653198473782,0.554975116158428,0.7565656795957224
57,41,13,5,0,8,5,5.069230769230769,0.3899408284023668,-2.0262685840944226,0.7823032673137773,0.44648898596924924,0.68864274532532
92,63,13,5,0,8,5,5.069230769230769,0.3899408284023668,-1.8988328581933602,0.683073427875804,1.180480692426293,1.2506668692272755
143,102,13,5,0,8,5,5.069230769230769,0.3899408284023668,0.2833528682724518,0.6202254577462001,0.9407913939951241,0.908819429217981
28,15,16,6,0,10,6,6.075,0.3796875,-2.0905349667780855,0.621361219408745,0.4805834596587014,0.6440146172350347
176,124,16,6,0,10,6,6.075,0.3796875,0.034722508405675666,0.5625302835545632,0.6762166172835785,0.8153652732038407
202,142,16,6,0,10,6,6.075,0.3796875,-4.732521817000965,0.6446944981457253,0.8743057426654863,1.0440112881645696
180,126,11,4,0,7,4,4.081818181818182,0.37107438016528926,-0.923959871167676,0.7563631287231035,0.6268793111634657,0.8764246433706787
70,47,14,5,0,9,5,5.085714285714285,0.36326530612244895,-0.45677097669946704,0.7005033939732499,0.3239922465212293,0.44501835574251863
199,139,14,5,0,9,5,5.085714285714285,0.36326530612244895,-3.2163156343157064,0.686055882970732,0.4990322104697122,0.6947424993880924
210,149,14,5,0,9,5,5.085714285714285,0.36326530612244895,-2.5836649732274255,0.6154249440840307,3.6391752002050812,1.33090122365656
48,34,17,6,0,11,6,6.088235294117647,0.35813148788927335,0.1292593563087869,0.6162788501351693,0.743528343051475,0.9039722480409587
214,153,9,3,0,6,3,3.1,0.34444444444444444,-1.375023106864794,0.8262119563364814,0.4503955645113126,0.567871895740065
35,22,12,4,0,8,4,4.1000000000000005,0.34166666666666673,-0.6238407451933144,0.6722751780358737,1.0449989113927642,1.0351208079910068
53,38,12,4,0,8,4,4.1000000000000005,0.34166666666666673,-0.3870981532642745,0.6928676465207384,1.2690082239528904,1.2441423858274963
151,109,12,4,0,8,4,4.1000000000000005,0.34166666666666673,0.13133939624317847,0.6920272735772851,0.6054792544436013,0.7906823389733987
30,17,15,5,0,10,5,5.1,0.33999999999999997,-3.491282058588651,0.6891599303980939,0.32953058615286585,0.48887609486991335
52,37,15,5,0,10,5,5.1,0.33999999999999997,-0.7011684825502776,0.5989876859628693,0.5399857076124425,0.6387373469710325
201,141,15,5,0,10,5,5.1,0.33999999999999997,-1.3560077006094162,0.6501537599481221,3.6037725551674544,1.5764837807222611
216,155,15,5,0,10,5,5.1,0.33999999999999997,-2.053593493914467,0.6535728743531052,0.6379441488159922,0.8749094476374256
229,167,15,5,0,10,5,5.1,0.33999999999999997,-0.17993505927133363,0.5965399250478902,0.7594369077907123,0.9125125862305068
43,29,18,6,0,12,6,6.1,0.33888888888888885,-0.1215011078694575,0.5562478255824064,0.9929017682785529,1.1645755385167038
164,117,16,5,0,11,5,5.1125,0.31953125,-4.244030401479151,0.6153362632420039,0.5339735785646645,0.69254481780411
219,158,13,4,0,9,4,4.115384615384616,0.31656804733727817,-1.12169479709035,0.7999000652027114,0.23089672947742154,0.36886187763955625
227,165,13,4,0,9,4,4.115384615384616,0.31656804733727817,-0.720956846954597,0.6913802975406639,0.7601563903221755,0.8041362147546238
191,133,10,3,0,7,3,3.12,0.312,0.10325522429902685,0.734418197229748,0.615697090938676,0.7670318000707942
26,13,17,5,0,12,5,5.1235294117647054,0.30138408304498265,-1.1154405404153578,0.6158482331435898,0.5500844491289074,0.7873726142925777
194,136,17,5,0,12,5,5.1235294117647054,0.30138408304498265,-2.548253114681215,0.5686523391174758,0.7580084747022819,0.887003010131162
206,145,17,5,0,12,5,5.1235294117647054,0.30138408304498265,-2.554630979445381,0.6015940731562975,0.5453386404456374,0.7704175461878509
32,19,14,4,0,10,4,4.128571428571429,0.2948979591836735,-0.7313053904626935,0.6778252178644971,0.38768954627617686,0.510858305072531
99,69,14,4,0,10,4,4.128571428571429,0.2948979591836735,-2.0662410210420155,0.7014323017893682,0.5532269434430882,0.866239083469073
159,115,14,4,0,10,4,4.128571428571429,0.2948979591836735,-3.4008803746260137,0.6724684324809528,0.7022287419558534,0.890851568538193
221,160,14,4,0,10,4,4.128571428571429,0.2948979591836735,-1.1884754333389713,0.665881196511601,0.6258674437825487,0.833542327801034
144,103,18,5,0,13,5,5.133333333333333,0.28518518518518515,-2.7822554631853906,0.6160079707306779,0.4625701396477193,0.6687780159770728
209,148,16,4,0,12,4,4.15,0.259375,-1.7033082185941357,0.6957103900632863,0.49453071518483227,0.7806665775977757
102,70,9,2,0,7,2,2.1666666666666665,0.24074074074074073,-1.8474635389542489,0.9661838008968172,0.42326667804456747,0.7763304852374635
36,23,18,4,0,14,4,4.166666666666666,0.23148148148148145,-1.6513726428191406,0.7805296286965264,1.5480677092602713,1.7434842867598268
163,116,18,4,0,14,4,4.166666666666666,0.23148148148148145,-2.9622676272834676,0.7195010490341449,1.5167077063775793,1.1752253504809311
157,114,14,3,0,11,3,3.1714285714285713,0.22653061224489796,-3.3671965997738837,0.7618578621299861,1.0651671739874142,1.3383087179622166
189,131,10,2,0,8,2,2.18,0.21800000000000003,-3.5647087610413872,0.9927182189111531,0.3109185722955042,0.5972982771564079
217,156,10,2,0,8,2,2.18,0.21800000000000003,-3.6011447454724634,1.0729431071232782,0.14798968759066305,0.2831410072721701
38,25,20,4,0,16,4,4.18,0.209,-1.945241590076977,0.6421064873579112,0.4214460126471075,0.7321529020479597
20,7,16,3,0,13,3,3.1875,0.19921875,-4.081312847629533,0.7073792550895548,0.40607950407397375,0.6460947840144055
213,152,16,3,0,13,3,3.1875,0.19921875,-4.009281760306935,0.8046338014011065,29.738954742994988,1.8650026433220128
142,101,12,2,0,10,2,2.2,0.18333333333333335,-1.2975852182432905,0.9025750720355146,0.3549436107716856,0.6150491869148704
91,62,13,2,0,11,2,2.207692307692308,0.1698224852071006,-2.387147594476656,0.8230875273670678,0.3335102164957201,0.6184377026527189
94,65,19,3,0,16,3,3.2052631578947364,0.16869806094182824,-4.917736011522263,0.7229467628317343,0.6247303377016685,0.9764095945975788
112,78,19,2,0,17,2,2.2368421052631575,0.11772853185595566,-2.699419325875133,0.751799723011377,0.7983845748371582,0.9921138164762934
179,125,16,1,0,15,1,1.2625,0.07890625,-6.226248957238143,0.967744940787449,0.3582382469847166,0.7764033305240083
