individual,id,Ntot,N1,ND,N0,raw,score,propscore,theta,se.theta,outfit,infit
55,55,33,33,0,0,33,32.699999999999996,0.9909090909090907,6.357004922000358,1.8678555266951344,0.009519282811490667,0.04622744584685277
112,112,31,30,0,1,30,29.719354838709677,0.9586888657648283,5.428327326036451,0.9890082167405874,0.081062923854029,0.45190010255544977
103,103,36,34,0,2,34,33.73333333333333,0.9370370370370369,5.014211674413985,0.767443309081699,0.45967096213257935,1.195548034383341
26,26,33,31,0,2,31,30.736363636363638,0.931404958677686,4.425257115610433,0.7636133464631824,0.21739458761433061,0.8130795627606925
37,37,36,33,0,3,33,32.75,0.9097222222222222,3.94759371805427,0.6665542379401769,0.3163116376447854,0.9006779458955293
67,67,36,33,0,3,33,32.75,0.9097222222222222,4.243750232543961,0.6377269118934,0.22146983549533045,0.6434794355711095
13,13,35,32,0,3,32,31.75142857142857,0.9071836734693877,4.212955281373365,0.6356344035916163,0.6286040589754588,0.8894471408451615
85,85,32,29,0,3,29,28.756249999999998,0.8986328124999999,4.034524989647144,0.7261163747097593,0.719272723204381,0.7670754023949983
66,66,32,28,0,4,28,27.775,0.86796875,4.06176114408478,0.6529610005936058,2.702411644500333,1.2297343559862193
83,83,32,28,0,4,28,27.775,0.86796875,3.5207776178041565,0.6312254280373178,0.3643014403699132,0.8359618291119729
1,1,35,30,0,5,30,29.785714285714285,0.8510204081632653,3.4158119903671316,0.5600928075204966,0.3016556852775488,0.690341234355922
12,12,34,29,0,5,29,28.788235294117644,0.846712802768166,3.7605224345150887,0.6041355713897307,0.4044506066571171,1.039136327684298
64,64,31,26,0,5,26,25.796774193548387,0.8321540062434963,3.360038609460848,0.6621180916215147,0.8417266653382567,1.6475560235319875
116,116,31,26,0,5,26,25.796774193548387,0.8321540062434963,3.0178271662436305,0.621149509914676,0.47534226913599353,1.0308631718823789
121,121,31,26,0,5,26,25.796774193548387,0.8321540062434963,3.528923693184379,0.6323345528854943,0.48172680412758906,1.045330146741668
102,102,34,28,0,6,28,27.805882352941175,0.8178200692041522,2.661694608100659,0.572242135270012,0.18031085994763316,0.3987679354074572
111,111,34,28,0,6,28,27.805882352941175,0.8178200692041522,3.5150667818719694,0.558567089494839,0.46370295980919546,0.9974510570881895
30,30,33,27,0,6,27,26.80909090909091,0.812396694214876,3.0189359777911164,0.5462496868968459,0.49056899926079867,0.7266296654200851
9,9,32,26,0,6,26,25.8125,0.806640625,3.5074836675959227,0.5862032893996227,0.5606832347680114,0.9771698144431976
95,95,32,26,0,6,26,25.8125,0.806640625,2.999841594815776,0.5717525074311015,0.4126504757552776,0.8215852812019209
56,56,37,30,0,7,30,29.813513513513513,0.8057706355003652,2.8714413550136215,0.5295853092019408,0.9306802651808066,0.9397114461766397
53,53,36,29,0,7,29,28.816666666666666,0.8004629629629629,2.855483853589226,0.5413368294248924,0.7208673813350986,1.1171729634226004
51,51,35,28,0,7,28,27.82,0.7948571428571428,2.897534075995972,0.5724072971940427,0.2591359128586663,0.6234984248852106
46,46,32,25,0,7,25,24.83125,0.7759765625,2.9083370186100828,0.5428495476676936,1.1265685937260985,1.2133153139332897
110,110,33,25,0,8,25,24.845454545454547,0.7528925619834711,2.412423665080273,0.5604846653482006,0.6104066167868312,0.7755408786080239
44,44,35,26,0,9,26,25.854285714285716,0.7386938775510205,1.891174412741827,0.5162852004840374,1.0239023294319267,1.5130485860500218
22,22,34,25,0,9,25,24.858823529411765,0.7311418685121107,1.35613682896026,0.5753991055387979,1.3109545721466749,0.7831055019982814
24,24,33,24,0,9,24,23.863636363636363,0.7231404958677686,2.3747438878061544,0.5273703991076534,0.35449371536291163,0.7213300163955683
81,81,29,21,0,8,21,20.86551724137931,0.7195005945303211,2.4909618511392315,0.6382029533796615,0.4902119980474748,0.917568219108679
54,54,36,26,0,10,26,25.866666666666667,0.7185185185185186,2.034553327811139,0.47794352067136764,0.5112121093527703,0.7562191314168862
73,73,36,26,0,10,26,25.866666666666667,0.7185185185185186,2.3250977374314763,0.5439960949926167,0.40472496331123486,0.8895894955127354
45,45,32,23,0,9,23,22.86875,0.7146484375,2.9118476046320088,0.525685002860316,0.31661337299743,0.5941381011975481
52,52,32,23,0,9,23,22.86875,0.7146484375,2.929097685626247,0.5264271821535104,0.7135886694929156,1.0809557424102292
59,59,32,23,0,9,23,22.86875,0.7146484375,2.3291291851567197,0.5396457133670794,0.9863981217967318,1.601679115311473
87,87,35,25,0,10,25,24.871428571428574,0.7106122448979593,2.3319055203247143,0.5392799702912588,0.38351119252891275,0.7733123939237722
3,3,34,24,0,10,24,23.876470588235293,0.7022491349480968,1.3268881944087034,0.523897375241866,0.3382526182049519,0.6442632445430629
77,77,34,24,0,10,24,23.876470588235293,0.7022491349480968,1.2630525341632315,0.5538378595118846,0.2404827778238659,0.5025744030991194
2,2,33,23,0,10,23,22.88181818181818,0.693388429752066,2.3903082902623938,0.5233238789454213,0.6211388001694927,1.0409185201601554
40,40,32,22,0,10,22,21.8875,0.683984375,2.1294213850507484,0.5421951440197631,0.4227063331061379,0.8638302505843813
49,49,33,22,0,11,22,21.9,0.6636363636363636,1.3120593671493628,0.514939901453321,0.5561472613588643,0.8360677264763966
29,29,30,20,0,10,20,19.900000000000002,0.6633333333333334,1.16176363436023,0.5789104886306029,0.5744358192902406,0.8271341714650426
35,35,35,23,0,12,23,22.905714285714286,0.6544489795918368,0.9786485631226542,0.5079887408714818,0.3860168215639964,0.6518780380910942
76,76,32,21,0,11,21,20.90625,0.6533203125,1.8828309461854038,0.5268025557801168,0.47660957620175115,0.7654482885175679
80,80,32,21,0,11,21,20.90625,0.6533203125,1.764306308554501,0.5053271566104413,0.5667588300130653,0.8781441559586833
16,16,31,20,0,11,20,19.912903225806453,0.6423517169614985,0.27882894076867915,0.5444707799595522,2.6251120397478958,1.7812227082936476
88,88,31,20,0,11,20,19.912903225806453,0.6423517169614985,1.6085854297955222,0.5526014793599259,2.1814903729061847,0.872230133079402
114,114,33,21,0,12,21,20.918181818181818,0.6338842975206611,1.2229662252006759,0.5089145993477734,0.49645908471693845,0.8157936871303104
20,20,32,20,0,12,20,19.925,0.62265625,0.9039672215656795,0.5800525628131232,0.18251462641820249,0.3818106533412036
57,57,34,21,0,13,21,20.929411764705883,0.6155709342560554,1.0479563890664116,0.5769542307002348,1.1061657794041349,1.095413185565135
31,31,37,22,0,15,22,21.94324324324324,0.5930606281957633,0.8840135766327477,0.5241289927735587,0.7432622029413805,1.0930178741424799
11,11,32,19,0,13,19,18.94375,0.5919921875,1.014070212900902,0.49874211221351955,0.8598228087231479,1.188535764160405
61,61,32,19,0,13,19,18.94375,0.5919921875,0.9856094375145816,0.5365924248580451,0.5117325527956231,0.8430649026099248
33,33,34,20,0,14,20,19.947058823529414,0.5866782006920416,0.5512381698288635,0.5229512830146653,0.46942936420726145,0.8727995680557591
7,7,36,21,0,15,21,20.95,0.5819444444444444,1.7995129955185665,0.4883959458812536,1.1017527178084041,0.9007560662316378
62,62,33,19,0,14,19,18.954545454545457,0.5743801652892563,0.7175232664680194,0.5523951746080039,0.5036157809485929,0.9114200898197522
10,10,35,20,0,15,20,19.95714285714286,0.5702040816326531,0.5751882480479898,0.4862066904778482,1.3767119307228646,1.1309558586865915
99,99,35,20,0,15,20,19.95714285714286,0.5702040816326531,0.24390920893094925,0.4914777721258438,1.0296846819516186,1.3657378383695413
105,105,32,18,0,14,18,17.9625,0.561328125,0.42219082199688496,0.5270947590948714,0.39266500843943425,0.6949142055984234
108,108,34,19,0,15,19,18.96470588235294,0.5577854671280277,1.5859848267609484,0.47119353464580305,0.9411584064515575,1.3177712397473675
86,86,35,19,0,16,19,18.974285714285717,0.5421224489795919,0.05893846745947527,0.4869596479090778,0.674265691242348,0.8416884466713136
15,15,32,17,0,15,17,16.98125,0.5306640625,-0.5439692450904273,0.5505850597084742,0.6911025516318208,0.9588051249203101
109,109,34,18,0,16,18,17.98235294117647,0.5288927335640138,0.36760201680388316,0.6201764769548682,0.8088982336852218,0.9194108413145292
84,84,36,19,0,17,19,18.983333333333334,0.5273148148148148,1.485145011110487,0.49715052214053074,0.9550216113949682,0.9897481643763019
58,58,35,18,0,17,18,17.99142857142857,0.5140408163265306,-0.32191644649679946,0.5089362950989075,0.4075048350619241,0.723067586129829
25,25,34,17,0,17,17,17,0.5,0.15715197837623077,0.5040705940576627,1.2100183187329596,1.2981843979274637
68,68,34,17,0,17,17,17,0.5,-0.9476144866435211,0.5461845824026399,0.4409214764965503,0.7993804068508298
115,115,34,17,0,17,17,17,0.5,0.4393230726104617,0.4456715729022563,0.594609156770811,0.8416895026641098
101,101,33,16,0,17,16,16.009090909090908,0.4851239669421487,-0.012578625869919828,0.5984488065967434,0.23619474573985996,0.5197416609042868
47,47,36,17,0,19,17,17.016666666666666,0.47268518518518515,-0.2750556278195601,0.46369526407948697,1.322511401883733,1.1411862647742539
113,113,32,15,0,17,15,15.01875,0.4693359375,0.35903892871723897,0.5145350201740865,0.4794376716495502,0.7824037452051453
119,119,30,14,0,16,14,14.02,0.4673333333333333,-0.6629433213175182,0.5962166876417907,0.32242850537608675,0.6912735857685908
92,92,36,16,0,20,16,16.03333333333333,0.4453703703703703,0.5231346302814089,0.49155505466628135,0.3506335427581828,0.6339140358333699
14,14,34,15,0,19,15,15.035294117647059,0.4422145328719723,-0.2574320789096042,0.5556081738084847,2.526281362742034,0.9017539742895735
43,43,32,14,0,18,14,14.0375,0.438671875,0.16504221980963465,0.4901853982870871,0.5075483013019295,0.7263348221901865
94,94,33,14,0,19,14,14.045454545454545,0.42561983471074377,-1.0632261076368679,0.5571562071434968,0.5192417555628301,0.7372095400597646
117,117,36,14,0,22,14,14.066666666666666,0.3907407407407407,-0.7401229484816673,0.5265484700425516,0.3947114805609959,0.6329040974332981
28,28,32,12,0,20,12,12.075,0.37734375,-1.0175760936905083,0.5042215620726065,0.9346652767756287,1.1403303889302205
69,69,35,13,0,22,13,13.077142857142858,0.3736326530612245,-1.6174091085848528,0.5375496899810053,0.2729186789954053,0.5727436760519652
74,74,35,13,0,22,13,13.077142857142858,0.3736326530612245,-1.6563257982395494,0.5449112950225178,0.9259987335632405,1.2812329288098436
6,6,29,10,0,19,10,10.093103448275862,0.348038049940547,-1.040745530252994,0.5567123829887777,0.26111577729588054,0.4887611247706619
118,118,32,11,0,21,11,11.09375,0.3466796875,-1.3726430985985516,0.62224098749131,1.2024602871690706,1.335952452953224
78,78,35,12,0,23,12,12.094285714285714,0.34555102040816327,-0.8291375078050276,0.517381832280798,0.7655014199049804,1.1864124419218252
70,70,36,12,0,24,12,12.1,0.3361111111111111,-0.7094132731560491,0.4912129796080964,0.6132628159818663,0.9241786075046432
72,72,34,11,0,23,11,11.105882352941176,0.32664359861591696,-1.0673922772666384,0.5348054285224283,0.4868286886467081,0.9214205436716345
120,120,34,11,0,23,11,11.105882352941176,0.32664359861591696,-2.4364336001928493,0.5322019277829532,0.929310950814567,1.2721200286013883
79,79,33,10,0,23,10,10.118181818181819,0.3066115702479339,-1.868410545698937,0.5641292846516599,0.8449385280622952,1.3707586346885734
60,60,34,10,0,24,10,10.123529411764707,0.2977508650519032,-1.445570313944172,0.5451787164167395,0.496237893581863,0.9186470629841227
122,122,35,10,0,25,10,10.12857142857143,0.28938775510204084,-1.9539544045328652,0.531782143542371,0.2699073835784205,0.5410881054476083
23,23,32,9,0,23,9,9.13125,0.2853515625,-2.1071958296434214,0.5270315660718577,0.44026267635685,0.8048357536365255
34,34,36,10,0,26,10,10.133333333333335,0.2814814814814815,-2.2719728231057648,0.5747771038940144,1.2371356866858276,0.7823019156814447
63,63,36,10,0,26,10,10.133333333333335,0.2814814814814815,-2.0611972499247186,0.5224270384476467,0.5973403557289436,0.7968420833656122
65,65,36,10,0,26,10,10.133333333333335,0.2814814814814815,-2.3280129984932536,0.5881785610730694,0.21503847899683068,0.5549965205539475
96,96,33,9,0,24,9,9.136363636363637,0.2768595041322314,-1.6218305789911456,0.5992477462099332,0.3768130908581352,0.7886138867228137
41,41,34,9,0,25,9,9.141176470588235,0.2688581314878893,-2.3500939852691087,0.5947615293660493,0.2140234452183689,0.5606000932287315
89,89,34,9,0,25,9,9.141176470588235,0.2688581314878893,-1.6165957664726869,0.5763552921683817,0.33758037139580294,0.7255554136972356
106,106,35,9,0,26,9,9.145714285714286,0.2613061224489796,-2.7119434156867865,0.6613984619278025,1.010022423017763,1.157544288121341
42,42,34,8,0,26,8,8.158823529411764,0.23996539792387542,-2.479990905309068,0.5687796413060401,0.6660502305976439,1.2109447317933892
32,32,37,8,0,29,8,8.17027027027027,0.22081811541271001,-2.465214878219125,0.5598610041614506,1.9859077460518555,1.24864523423813
71,71,34,7,0,27,7,7.1764705882352935,0.21107266435986158,-2.475230420708759,0.5781101194496767,0.3244175340565313,0.7734183588240302
36,36,35,7,0,28,7,7.18,0.20514285714285713,-2.893956235544089,0.5635681728456257,0.5991593011456816,1.077449579653927
75,75,35,7,0,28,7,7.18,0.20514285714285713,-2.2662494474212993,0.5841099514474823,0.2647553160119049,0.6746622671132639
39,39,31,6,0,25,6,6.183870967741934,0.1994797086368366,-2.529591459570649,0.7214345164517205,0.3837335428458816,0.8827549543136587
27,27,32,6,0,26,6,6.187499999999999,0.19335937499999997,-3.523657798054621,0.7211673971936629,0.15999926509608395,0.5149697614378554
82,82,33,6,0,27,6,6.1909090909090905,0.18760330578512396,-2.8647865531445973,0.6055512856146397,0.25704937276784295,0.6560863649189204
104,104,34,6,0,28,6,6.194117647058823,0.18217993079584774,-3.9054634084007978,0.7004437327478634,0.23142899131952024,0.6608957098874824
5,5,35,6,0,29,6,6.197142857142857,0.17706122448979592,-3.2736204028276816,0.670251238080471,0.3571168756290228,0.9727554192756496
18,18,36,5,0,31,5,5.216666666666667,0.1449074074074074,-3.4663536548519387,0.7764353134831983,0.5362861698357064,1.3938198846139624
19,19,33,4,0,29,4,4.2272727272727275,0.12809917355371903,-3.697912296177313,0.6838752056800189,1.88045430623137,1.1812581564347242
90,90,35,4,0,31,4,4.231428571428571,0.12089795918367346,-5.062647073311252,0.828399460584255,0.0964487399862888,0.42878370731533705
93,93,35,4,0,31,4,4.231428571428571,0.12089795918367346,-2.976911124552606,0.6066824876922703,0.2604556916794033,0.6751639635923177
97,97,35,4,0,31,4,4.231428571428571,0.12089795918367346,-4.607722425603547,0.7444483249557544,0.3130537562157915,1.1772544173223471
50,50,31,3,0,28,3,3.241935483870967,0.10457856399583765,-4.437063854368118,0.6994961486205609,0.7335063338931985,1.093509133333881
17,17,35,3,0,32,3,3.2485714285714282,0.09281632653061224,-4.145481479545371,0.7511386864854829,0.08866763159344312,0.3045337313199903
48,48,35,3,0,32,3,3.2485714285714282,0.09281632653061224,-3.9292629972008517,0.7314851391798461,0.10207547813981432,0.34716410417486243
100,100,36,3,0,33,3,3.2499999999999996,0.09027777777777776,-4.302880635424612,0.8252522968873818,0.0723839921348697,0.29943720666862617
38,38,35,2,0,33,2,2.2657142857142856,0.06473469387755101,-5.015135592625089,0.9211532790966072,0.2832186537457377,0.8562926263343517
98,98,35,2,0,33,2,2.2657142857142856,0.06473469387755101,-5.052215951989711,0.9611493923977502,0.08054284402986586,0.5013342836368637
8,8,29,1,0,28,1,1.2793103448275862,0.044114149821640906,-4.95335457379579,1.1460545717890818,0.5128798690389299,1.7981264100172478
21,21,34,1,0,33,1,1.2823529411764705,0.03771626297577854,-5.524350877563428,0.9984363032023744,0.08484722363823168,0.5560364143261003
107,107,33,0,0,33,0,0.3,0.00909090909090909,-6.7668937374387514,1.91381500503368,0.010051922999304228,0.09938442765576593
4,4,34,0,0,34,0,0.3,0.008823529411764706,-7.396057598292842,1.8712204873565312,0.009288876554675599,0.05102333733076402
91,91,35,0,0,35,0,0.3,0.008571428571428572,-7.637660605100179,1.875460508311035,0.009061075173398042,0.0557906670819447
